elmost: molest, motels
cdeiinnoorst: conditioners, reconditions
acdeeefnorst: Confederates, confederates
aaceinrs: Canaries, canaries, cesarian
beosss: bosses, obsess
f: F, f
g: G, g
d: D, d
e: E, e
b: B, b
c: C, c
a: A, a
n: N, n
o: O, o
l: L, l
m: M, m
j: J, j
k: K, k
h: H, h
i: I, i
w: W, w
v: V, v
u: U, u
t: T, t
s: S, s
r: R, r
q: Q, q
p: P, p
z: Z, z
y: Y, y
x: X, x
eeilrv: eviler, relive, revile
eeksw: Weeks, weeks
cmmnoos: Commons, commons
eginors: ignores, regions
'afist: Fiat's, fiat's
eekps: keeps, peeks
eeilos: Eliseo, Eloise
aegikln: leaking, linkage
'aceillops: Calliope's, calliope's
'apstty: Patty's, patty's
eekns: keens, knees
dmooorww: woodworm, wormwood
ehkoor: Hooker, hooker
'einpsst: instep's, spinet's
eekls: keels, leeks, sleek
adefltu: default, faulted
aaamrs: Asmara, Samara
fgilnow: flowing, fowling, wolfing
eeorsst: Orestes, stereos
agimnr: Ingram, arming, margin
abgrs: brags, garbs, grabs
aeghilnoost: anthologies, theologians
agimnt: mating, taming
beilrsst: blisters, bristles
adenstv: Advents, advents
'ceillors: Collier's, collier's
'abdrs: Brad's, bard's, brad's, drab's
'horstw: throw's, worth's
'begins: being's, binge's
'efirsst: sifter's, strife's
'abdsu: baud's, daub's
bddeir: bidder, birded
'horsst: Short's, short's
'bins: bin's, nib's
aeinstv: naivest, natives, vainest
denrssu: sunders, undress
befirs: briefs, fibers
'abelstt: Battle's, battle's, tablet's
abgilmnr: marbling, rambling
eginntt: netting, tenting
cdeinorstu: introduces, reductions
aellru: Laurel, allure, laurel
ghnosstu: gunshots, shotguns
eelrstt: letters, settler, trestle
adeepprr: dapperer, prepared
beorst: Osbert, sorbet, strobe
beorsw: Bowers, bowers, browse
eelrstw: swelter, welters, wrestle
eginnst: nesting, tensing
'cehnorsv: Chevron's, chevron's
eginnss: ensigns, sensing
aellps: Aspell, lapels
deiins: Indies, inside
elmnot: Melton, molten
elmnos: lemons, melons, solemn
'aelrstt: latter's, rattle's
'aelrstv: travel's, varlet's
'blosw: blow's, bowl's
abchnr: Branch, branch
aaceimnr: American, Cinerama
cceilr: circle, cleric
'aelrssv: salver's, slaver's
adeeiln: Adeline, aliened
'blost: blot's, bolt's
adeeilm: emailed, limeade
agiinrs: airings, arising, raising
'abest: beat's, beta's
'abesu: Beau's, beau's
'apssty: Patsy's, pasty's, patsy's
'anors: Arno's, Aron's, Nora's, Oran's, roan's
aelsstt: saltest, stalest
deegls: ledges, sledge
'abers: Reba's, bear's
aegilnt: elating, gelatin, genital
aegilns: leasing, sealing
aegilnp: leaping, pealing
eejlw: Jewel, jewel
eimrss: misers, remiss
eimrst: Mister, merits, mister, miters, remits, timers
'abens: Bean's, bane's, bean's
adeeiss: disease, seaside
agiinnr: ingrain, raining
agillnott: allotting, totalling
'acdeilst: citadel's, dialect's
eenqsu: Queens, queens
'abels: Abel's, Bela's, bale's
'abeks: bake's, beak's
aginpr: paring, raping
adenrsw: Andrews, wanders, wardens
adenrss: Sanders, sanders
eenrsu: ensure, enures
eenrsv: Severn, nerves
eenrst: Ernest, Sterne, enters, resent, tenser
aginrt: rating, taring
eenrtu: neuter, tenure, tureen
aginst: giants, sating
ddiru: Druid, druid
'lsstu: lust's, slut's
'bceks: Beck's, beck's
inopst: pintos, piston, pitons, points
'acdeilms: decimal's, medical's
deegry: greedy, greyed
aghinprs: phrasing, sharping
aeinrrt: retrain, terrain, trainer
cpsu: cups, cusp
abgilnst: blasting, stabling
aeinrst: nastier, retains, retinas
abgilnrw: brawling, warbling
'accgnos: Cognac's, cognac's
'bjos: Job's, job's
aeghiknnr: hankering, harkening
iktty: Kitty, kitty
'aeilmoqssttu: Milquetoast's, milquetoast's
'bcesu: Cebu's, cube's
aeinrtt: nattier, nitrate
aginnw: awning, waning
aellty: Talley, lately
eeinr: Ernie, Irene
aelmnt: Mantle, lament, mantel, mantle, mental
'ceeprsst: respect's, scepter's, specter's
aelmny: Manley, laymen, meanly, namely
celrtuy: cruelty, cutlery
eeils: Elise, Elsie
aelmps: maples, sample
aelmpr: Marple, Palmer, ampler
aelmrt: Martel, armlet
aelmst: lamest, metals
acessu: causes, sauces
ainprstu: Rasputin, puritans
aaimnsst: Satanism, mantissa, satanism
eeiinoprtt: petitioner, repetition
adeehrs: adheres, headers, sheared
ceirrstt: critters, restrict, stricter
ceirrstu: crustier, recruits
giilnps: lisping, pilings
'ceilpprs: clipper's, cripple's
cdeenst: descent, scented
giilnst: listing, silting
eprsu: purse, super
'anpss: snap's, span's
eprsy: Ypres, preys, pyres
cdeenor: encoder, encored
giilntt: Tlingit, tilting, titling
inoopt: option, potion
'aceilnosst: coastline's, sectional's
'eorssty: oyster's, storey's
aeprstt: patters, spatter
aeprstu: Pasteur, pasture
eijnors: joiners, rejoins
'eegrss: Segre's, serge's
bdeerttu: buttered, rebutted
'abbsy: Abby's, baby's
'abehrst: Bertha's, bather's, breath's
efhirs: Fisher, fisher
'bgos: bog's, gob's
eenstv: Steven, events
aeprsst: repasts, sparest
ittw: Witt, twit
deeinrst: Dniester, inserted, nerdiest, resident, trendies
abiss: basis, bassi
egirstu: gustier, gutsier
eehst: sheet, thees, these
aeeegrst: eagerest, steerage
'acilnorst: cilantro's, contrail's
cdeiprst: predicts, scripted
demoor: moored, roomed
eehrt: ether, there, three
eehrw: hewer, where
deeeinnrtv: intervened, reinvented
aceeirtv: creative, reactive
'egpstu: Puget's, getup's
abinr: Brain, Brian, Rabin, brain
abins: Sabin, basin
eeegnr: Greene, renege
'adeefilrsst: Federalist's, federalist's
deeinrrt: interred, trendier
'dfoorsx: Oxford's, oxford's
deikln: kilned, kindle, linked
aelnrs: Larsen, learns
aelnrv: Lavern, vernal
aelnrt: antler, learnt, rental
aelnru: Lauren, neural, unreal
ddeefil: defiled, fielded
ddeefii: deified, edified
enorrtuv: overturn, turnover
cimmmnosu: Communism, communism
aelnor: Elanor, Elnora, Lenora, Lorena, loaner
di: Di, id
eehlt: Ethel, Lethe
dr: Dr, Rd
ex: Xe, ex
aelnpt: planet, platen
aelnps: Naples, panels, planes
eh: He, eh, he
eg: GE, Ge
em: em, me
es: Es, Se, es
er: Er, Re, re
abils: Basil, bails, basil
abilr: Blair, Libra
by: Yb, by
br: Br, Rb
'eghins: hinge's, neigh's
aaeehhimprtt: amphitheater, amphitheatre
be: Be, be
aceginrrt: cratering, retracing, terracing
cs: Cs, Sc, cs
accdekl: cackled, clacked
aceginrst: caterings, recasting
at: At, Ta, at
as: As, as
ar: Ar, Ra
aelntt: latent, talent
av: Av, Va
al: Al, La, la
ap: Pa, pa
am: Am, am, ma
an: Na, an
ac: Ac, Ca
ag: Ag, Ga
ah: ah, ha
no: no, on
os: Os, so
adeegnr: angered, derange, enraged, grandee, grenade
lt: Lt, Tl
mt: Mt, Tm
'aceinorst: Creation's, creation's, reaction's
ms: Ms, Sm, ms
mu: mu, um
deeefr: feeder, reefed
epsst: pests, steps
aceeinrsst: ancestries, resistance
ccimos: comics, cosmic
epstu: setup, upset
ho: Ho, ho, oh
is: Si, is
it: It, Ti, it, ti
giilmpr: Pilgrim, pilgrim
in: In, Ni, in
deeelr: leered, reeled
'beglsu: bugle's, bulge's
adenttu: attuned, taunted
adeegrw: ragweed, wagered
cdeirst: credits, directs
ceiknrss: Snickers, snickers
st: St, ts
deeepr: deeper, peered
rs: Sr, rs
ru: Ru, Ur
agilmn: laming, malign
aaelmnu: Manuela, alumnae
ceirrssu: cruisers, scurries
deeerv: reeved, veered
agilns: aligns, signal
pu: Pu, up
aeinprt: painter, pertain, repaint
aeinprs: Persian, paniers
aeinpst: panties, sapient
crtu: Curt, curt
cehinopst: Ctesiphon, phonetics
'aeehrstt: theater's, theatre's
crux: Crux, crux
istw: wist, wits
eegrt: egret, greet
eegrs: Segre, serge
aaimnor: Mariano, Romania
aaimnrt: Martian, Martina
aghilmorst: algorithms, logarithms
aeegrs: agrees, grease
giillnt: lilting, tilling
cehist: ethics, itches
aehlrst: halters, lathers, slather
bhrsu: brush, shrub
cefirty: certify, rectify
eptty: Petty, petty
aeegnr: enrage, genera
aeegnv: Geneva, avenge
ahopst: pathos, potash
eemprsu: presume, supreme
'blrsu: Burl's, blur's
ablms: balms, lambs
'aiprss: Paris's, Parsi's
ccdnoor: Concord, concord
cloo: Colo, cool, loco
clot: Colt, clot, colt
inst: nits, snit, tins
aeeiimprstv: imperatives, semiprivate
aaginnostt: antagonist, stagnation
ailorsty: royalist, solitary
inps: nips, pins, snip, spin
bbcelor: clobber, cobbler
addlnoosw: downloads, woodlands
inor: Orin, iron
inot: Toni, into
adddelw: dawdled, waddled
aghinsst: Hastings, stashing
aeilnssst: saltiness, stainless
'abegls: bagel's, gable's
adeefst: deafest, defeats, feasted
cehils: chiles, chisel
'bsstu: bust's, stub's
cehins: inches, niches
bhorst: broths, throbs
aaceglotu: catalogue, coagulate
cdeeiklnnoo: Nickelodeon, nickelodeon
eeilrsv: relives, reviles, servile
eenst: teens, tense
eenss: Essen, sense
eensv: evens, seven
aegmnost: magnetos, megatons, montages
eenrv: Verne, nerve, never
eenrw: newer, renew
adelorst: leotards, lodestar
'deeilss: Diesel's, diesel's
acertu: acuter, curate
cenoorrs: coroners, crooners
ghilopsstt: spotlights, stoplights
eenqu: Queen, queen
adefint: defiant, fainted
'noopss: snoop's, spoon's
imst: mist, smit
imss: Miss, Sims, isms, miss
acersv: carves, craves
acerst: carets, caster, caters, crates, reacts, recast, traces
acerss: caress, scares
bdoor: Dobro, brood
acerrt: Carter, Crater, crater, tracer
acerrv: Carver, carver
cehkors: chokers, shocker
abkns: Banks, banks
aacestv: caveats, vacates
'imnost: Minot's, Timon's
ckor: Kroc, Rock, cork, rock
ckoo: Cook, cook
'abegilns: Algenib's, Belgian's, Bengali's
aehlsss: hassles, slashes
'imnors: Morin's, minor's
ckpu: Puck, puck
'admnosy: Monday's, dynamo's
aeeirrt: Eritrea, tearier
adennoy: annoyed, anodyne
deeeiprstx: expediters, preexisted
ddego: Dodge, dodge
aeeglt: eaglet, legate
ddeir: dried, redid
'aegorsvy: Voyager's, voyager's
'bfis: FBI's, fib's
aeeirs: aeries, easier
cginnor: Corning, corning
'acdnors: Dacron's, candor's
eemns: Menes, semen
'adhors: Rhoda's, hoard's
eemny: Yemen, enemy
'aehnorsstt: Northeast's, northeast's
eemst: meets, metes, teems
'adellnrs: Darnell's, Randell's
eemry: Emery, Meyer, emery
'aceirrrs: Carrier's, carrier's
elorsuv: louvers, velours
abeeilrst: beastlier, bleariest, liberates
orttu: trout, tutor
aeinrstt: nitrates, straiten
inooprst: portions, positron
dmooy: Moody, moody
dmoos: Sodom, dooms, moods
'ceeilnss: license's, silence's
'arsst: star's, tsar's
eghhist: eighths, heights, highest
abnru: Urban, unbar, urban
aegrsty: grayest, gyrates
cost: Scot, cost, cots
cosw: cows, scow
'cemrrsuy: Mercury's, mercury's
ipss: piss, sips
ipst: pits, spit, tips
fgiiknn: finking, knifing
aeilnorst: Orientals, orientals, relations
aeeeeinprrsttv: Representative, representative
abeelnt: Beltane, tenable
abgnor: Bangor, brogan
eerstt: setter, street, tester
aaeemnst: emanates, manatees
'eegnrs: Green's, genre's, green's
eerssv: serves, severs, verses
eersst: esters, resets, serest, steers
cdeersu: reduces, rescued, secured, seducer
'giorsv: Virgo's, vigor's
mstu: Tums, must, smut
'aceprss: parsec's, scrape's
aennors: Rosanne, Roseann
mssu: muss, sums
bdenoru: bounder, rebound
eeforrsst: foresters, reforests
aachimrs: archaism, charisma
aeehrt: heater, reheat
cginost: Gnostic, costing
eenopr: opener, reopen
aeehsv: heaves, sheave
eelmr: Elmer, Merle
cginops: copings, scoping
aceprs: capers, crapes, parsec, recaps, scrape
eeenprst: Petersen, preteens, pretense
aagilmnr: alarming, marginal
'klooostu: lookout's, outlook's
'adeegnrs: grandee's, grenade's
'bdsu: Bud's, bud's, dub's
'deeinrs: Nereid's, denier's
eelps: peels, sleep
eelpr: leper, repel
eeilmnost: limestone, milestone
deeerrsv: reserved, reversed
orstu: routs, torus, tours
orstt: torts, trots
eelst: sleet, steel
orsty: story, troys, tyros
abmru: Burma, rumba
eefiisstt: feistiest, testifies
eelrs: leers, reels
orssu: Russo, sours
cciirt: citric, critic
eelrv: lever, revel
cmsu: cums, scum
aeinrrst: restrain, retrains, strainer, terrains, trainers
'egnrsty: Gentry's, gentry's
abckls: Blacks, blacks
'aennrst: Tanner's, tanner's
aegrrst: garrets, garters, graters
adenpsx: expands, spandex
iort: riot, tiro, trio
hnstu: hunts, shunt
'abehrs: Haber's, rehab's
aceginnrt: cantering, recanting
aahmnort: Marathon, marathon
ceeinorrrstu: Resurrection, resurrection
'bdes: bed's, deb's
aeghnopst: heptagons, pathogens
aeeiln: Aileen, Elaine
crstuy: crusty, curtsy
'aclrssty: Crystal's, crystal's
ainopstu: Utopians, utopians
ainopsss: Passions, passions
adenpps: appends, snapped
'forsst: Frost's, frost's
'als: Al's, La's, la's
eestw: Sweet, sweet, weest
aeeltz: teazel, teazle
'ams: AM's, Am's, MA's, ma's
aaadilmnt: Dalmatian, dalmatian
aeelrs: reales, resale, sealer
'aps: PA's, Pa's, pa's
aeelss: easels, leases
aeelst: Estela, elates, teasel
eessx: Essex, sexes
aeelps: asleep, elapse, please
'ars: Ar's, Ra's
'ast: At's, Ta's
aeelnr: Arlene, leaner
cinost: tocsin, tonics
aaadmr: Ramada, armada
'aaadmrs: Ramada's, armada's
aeinrv: naiver, ravine, vainer
aeinrt: retain, retina
cfhin: Finch, finch
ccmooor: Morocco, morocco
aeinpr: Napier, panier, rapine
aeinpt: pantie, patine
cddeeinrs: discerned, rescinded
oprsst: sports, strops
iprst: strip, trips
iprsu: Prius, sirup
oprstu: Proust, sprout, stupor
cdeeeirv: deceiver, received
chko: Koch, hock
deenrs: denser, resend, sender
deenrv: Denver, nerved, vender
deenru: endure, enured
deenrt: rented, tender
'abelss: Basel's, sable's
aeeimrt: emirate, meatier
ijno: Joni, join
deensu: endues, ensued
deenst: nested, tensed
'abelst: bleat's, table's
ckmos: mocks, smock
chmu: chum, much
deentt: netted, tented
'abelms: Mabel's, Mable's, amble's, blame's
'lpssuu: Lupus's, lupus's
ceilpprs: clippers, cripples
deenor: Doreen, redone
chir: Rich, rich
chin: chin, inch
chit: chit, itch
acegors: cargoes, corsage
afrst: farts, frats, rafts
'abinrs: Brain's, Brian's, Rabin's, brain's
aaelsst: Atlases, atlases
'aelnorss: Orleans's, Salerno's
'abells: Bella's, label's
acckoss: Cossack, cassock
aelsst: slates, stales, steals, tassel
aelssv: salves, slaves
aelstx: exalts, laxest
eenrrst: renters, sterner
chou: Chou, ouch
corss: Cross, cross
flnoopssu: spoonfuls, spoonsful
cdeinostu: seduction, suctioned
addlnoow: download, woodland
eerst: Ester, ester, reset, steer, terse, trees
eersv: serve, sever, veers, verse
eersw: ewers, sewer
aeghnorsv: hangovers, overhangs
aeeilmnnst: alinements, lineaments
'beensstu: Steuben's, subteen's
aimqrsu: Marquis, marquis
aelnrtu: Laurent, Renault, neutral
bbbgilno: blobbing, bobbling
aeeilrsz: realizes, sleazier
adeerrs: readers, rereads
aeeilrst: ateliers, earliest
'aahmnorst: Marathon's, marathon's
adeerst: dearest, sedater
acdeehrtt: chattered, ratcheted
aeekmr: Kareem, remake
'alpssy: palsy's, splay's
'binors: Robin's, robin's
abost: boast, boats
iikw: kiwi, wiki
'abekrs: baker's, brake's, break's
'aeeijnns: Jeanine's, Jeannie's
'bgrsu: burg's, grub's
adeeggrst: raggedest, staggered
deeotv: devote, vetoed
aeiprr: rapier, repair
aeiprs: Persia, aspire, praise, spirea
'abs: AB's, BA's, Ba's
'cehirs: Cheri's, Erich's, Reich's
deeors: erodes, redoes
deilops: despoil, spoiled
aeeinrt: retinae, trainee
efghirt: fighter, freight
deilors: Deloris, soldier, solider
'bbos: Bob's, bob's
dfoorsx: Oxfords, oxfords
'cehils: Chile's, chile's
'ads: DA's, ad's
aelnssu: sensual, unseals
'acs: AC's, Ac's, Ca's
iirs: Iris, iris
efflrtu: fretful, truffle
'ags: Ag's, Ga's
'eglns: Glen's, glen's
'eglos: Lego's, loge's, ogle's
'cos: CO's, Co's
aacikmnw: Mackinaw, mackinaw
cdeinortu: introduce, reduction
eeirrt: Terrie, retire
admooppru: Pompadour, pompadour
'css: SC's, Sc's
'cst: CT's, Tc's
cdeeers: decrees, recedes
acfiinnort: infarction, infraction
eprrsy: Sperry, spryer
eghhinss: Highness, highness
'ehinrss: shiner's, shrine's
'efrrsy: ferry's, fryer's
'aairst: Atari's, Atria's, tiara's
aeenrr: earner, nearer
illm: Mill, mill
illw: Will, will
ills: ills, sill
illt: lilt, till
cffil: Cliff, cliff
aeenst: Senate, sateen, senate
illy: Lily, lily
'eellnos: Leonel's, Noelle's
'aenorsst: senator's, treason's
ckops: Spock, pocks
eirssttu: rustiest, trusties
ilps: lips, lisp, slip
'abenrs: Abner's, Arneb's
cjko: Jock, jock
'des: Ed's, ed's
aehprss: phrases, seraphs
ilos: Lois, oils, silo, soil, soli
ilor: Lori, roil
ilno: Olin, lion, loin
eiknrstt: knitters, trinkets
ilms: mils, slim
ilmo: Milo, limo
'oorsst: roost's, torso's
abeorst: boaster, boaters
ilst: list, silt, slit
begilnss: blessing, glibness
ckors: corks, rocks
ckory: Rocky, rocky
aehisstt: atheists, hastiest
deelpy: deeply, yelped
deelrw: lewder, welder
'dms: MD's, Md's
'dps: DP's, Pd's
cffsu: cuffs, scuff
'dos: OD's, do's
eeirvw: review, viewer
aersttt: tartest, tatters
'dis: ID's, id's
aersttu: astuter, stature
aersttw: Stewart, swatter
'cdeeiklnnoos: Nickelodeon's, nickelodeon's
'aeflmorswy: Mayflower's, mayflower's
'bsy: Yb's, by's
acginost: agnostic, coasting, coatings
'brs: Br's, Rb's
'bss: BS's, Sb's
'bst: TB's, Tb's
deforst: defrost, frosted
'bms: BM's, MB's
adeeprv: deprave, pervade
'ghinst: night's, thing's
adeeprt: predate, tapered
eprssu: purses, supers
eprstu: erupts, purest
deersst: deserts, dessert
aeemnr: meaner, rename
aeemns: enemas, seamen
cimmnosstu: Communists, communists
deerstw: strewed, wrested
deeginrss: designers, redesigns
'gins: ING's, gin's
aeempr: Ampere, ampere
iklo: Loki, kilo
ikln: kiln, link
ikls: ilks, silk
cilo: Clio, coil, loci
'abemrs: Amber's, amber's
cikr: Rick, rick
cikn: Nick, nick
aeirss: arises, raises
ikno: ikon, oink
ikns: inks, sink, skin
'cds: CD's, Cd's, DC's
aeirrv: Rivera, arrive
aeeeprrt: repartee, repeater
deefgin: feeding, feigned
deemot: demote, emoted
ikrs: Kris, irks, risk
cino: coin, icon
aeirvw: waiver, wavier
ikst: kits, skit
ikss: kiss, skis
cosst: Scots, costs
acimnos: Masonic, masonic
eeprs: Speer, peers, spree
eeprt: Peter, peter
eepru: puree, rupee
eepsw: sweep, weeps
aeeiilrst: Israelite, realities
'eimnrsv: Mervin's, vermin's
deefiilnrs: friendlies, infielders
ceelors: Creoles, creoles
'egilnnosst: Singleton's, singleton's
einrstw: Winters, winters
einrstv: inverts, striven
deggilns: geldings, sledging
einrssu: insures, sunrise
deerrss: dresser, redress
adenoprtv: Davenport, davenport
aelnors: Orleans, Salerno, loaners
cdsu: Scud, cuds, scud
ehkoorsuw: housework, workhouse
'binrsu: Rubin's, bruin's
'aailss: Alisa's, alias's
ceeprst: respect, scepter, specter
'aailsv: Avila's, avail's
aelorsvy: layovers, overlays
cdos: cods, docs
'aemnprssu: Superman's, superman's
cdru: crud, curd
eeeinnrst: Ernestine, internees
cdlo: clod, cold
'eimnstu: minuet's, minute's
'aeghrst: Gareth's, gather's
achlors: chorals, scholar
'anrsy: Ryan's, yarn's
'doors: door's, odor's, rood's
cdik: Dick, dick
'anrst: Tran's, rant's
cdei: dice, iced
cdeo: code, coed
ekorrsw: reworks, workers
eeginrrsv: reserving, reversing
acchilot: Catholic, catholic
'aceenrrst: Terrance's, recreant's
eginstw: stewing, twinges
eginstt: setting, testing
beffru: buffer, rebuff
'aflos: Olaf's, foal's, loaf's
eginsst: ingests, signets
aaffir: affair, raffia
ceepstx: excepts, expects
eimnrv: Mervin, vermin
eefilst: lefties, liefest
aepsst: pastes, spates
eikpprs: kippers, skipper
'aaimrs: Maria's, maria's
agillnsy: sallying, signally
eefilrs: refiles, reliefs
eimntu: minuet, minute
'aceerrst: caterer's, terrace's
abstu: abuts, tabus, tubas
'aainprsst: aspirant's, partisan's
'doprs: drop's, prod's
aelpry: parley, pearly, player, replay
allosww: swallow, wallows
eefhrsst: freshest, freshets
afknrs: Franks, franks
eflrstu: fluster, restful
agimnrst: migrants, smarting
eimnos: Simone, monies
eimnor: Merino, merino
ccehios: Cochise, choices
'anstw: want's, wasn't
'anstu: aunt's, tuna's
'cirsstu: Curtis's, citrus's, rustic's
cehrry: Cherry, cherry
'defils: Fidel's, field's
deefilr: fielder, refiled
adeemnr: meander, renamed
aeeijnn: Jeanine, Jeannie
deilstu: dilutes, duelist
deefinr: definer, refined
bdeghhoorrtu: Thoroughbred, thoroughbred
deefiis: deifies, edifies
elmrty: Myrtle, myrtle, termly
'ennostw: Newton's, newton's
'acdilnors: Alcindor's, ironclad's
aelpst: palest, pastel, petals, plates, pleats, staple
aelpss: lapses, passel, sepals
hiiknps: kinship, pinkish
adeemrr: dreamer, rearmed
ekorsst: stokers, strokes
cdeenorsv: conserved, conversed
hillooprw: Whirlpool, whirlpool
cdeenortu: countered, recounted
aeervw: Weaver, weaver
histw: whist, whits
ceelmnt: Clement, clement
glpsu: gulps, plugs
dfoorx: Oxford, oxford
cdeeirs: decries, deicers
eginrst: resting, stinger
eginrsw: swinger, wingers
eginrsv: serving, versing
eginrss: ingress, resigns, signers, singers
cefiklr: fickler, flicker
adeilnprtu: Prudential, prudential
aeeegnrt: generate, teenager
'aainst: Anita's, Tania's
cehikstt: thickest, thickets, thickset
nopsstu: sunspot, unstops
cdeiinoprst: description, predictions
'dsstu: dust's, stud's
'efilrs: flier's, lifer's, rifle's
aafghn: Afghan, afghan
aefgiln: finagle, leafing
'aberss: Sabre's, saber's, sabre's
aabdlorrs: Labradors, larboards
cehops: Cheops, epochs
ckstu: stuck, tucks
deprsuu: pursued, usurped
acelmor: Carmelo, Marcelo
aelqsu: equals, squeal
aelnrst: antlers, rentals
cehort: Hector, hector
acginrsv: carvings, cravings
eopssu: opuses, spouse
eeinsv: Nieves, envies
'ceeorrssu: recourse's, resource's
adeelps: elapsed, pleased
adeelpr: pearled, pleader
adeelrs: dealers, leaders
adeelrt: alerted, altered, related, treadle
adeelrw: Leeward, leeward
adeelry: layered, relayed
gloss: gloss, slogs
aagnorrt: arrogant, tarragon
aeersv: Varese, averse
aeerss: erases, sarees
aeerst: Easter, Teresa, eaters, teaser
adeelnp: deplane, paneled
adeelnr: Darlene, Leander, learned
cfio: coif, foci
'adeelrsw: Leeward's, leeward's
accdeefnory: Confederacy, confederacy
'eglrsu: Luger's, gruel's
egiilnrv: reliving, reviling
ceinnnott: Continent, continent
'aesstw: sweat's, waste's
'aesstv: Vesta's, stave's
'aesstt: state's, taste's
'aessty: Yeats's, yeast's
'aessst: Tessa's, asset's
aceghint: cheating, teaching
aaeiprst: aspirate, parasite
'ehlosst: Lhotse's, hostel's
'ghirst: girth's, right's
'aeflors: Loafer's, loafer's
aelnpst: planets, platens
ceru: cure, ecru
'aaadilmnst: Dalmatian's, dalmatian's
deeisv: devise, sieved
ceefiirst: certifies, rectifies
aelnpty: aplenty, penalty
'inoopst: option's, potion's
cdeenors: censored, encoders
cekp: Peck, peck
ceko: Coke, coke
deeinv: endive, envied, veined
deeinr: Nereid, denier, reined
deeins: Denise, denies
acellry: Carlyle, clearly
acellrs: callers, cellars, recalls
cdeenpru: Prudence, prudence
celo: Cleo, Cole
celu: Luce, clue
eimprs: primes, simper
eimpru: impure, umpire
cein: Nice, nice
ceir: Eric, Rice, rice
deeils: Diesel, diesel, elides
deeilv: levied, veiled
eoprtt: Potter, potter
eoprsw: Powers, powers
eoprss: posers, spores
eoprst: poster, presto, tropes
ceot: Cote, cote
deeirs: desire, eiders, reside
aelrtt: latter, rattle
aelrtv: travel, varlet
cdeeorst: corseted, escorted
eoprrt: Porter, porter, report
cehpsy: Psyche, psyche
aelrsy: layers, relays, slayer
'agnrst: Grant's, grant's
aelrst: Slater, alerts, alters, salter, staler
aelrsv: ravels, salver, slaver
'aaginsu: Guiana's, iguana's
ceno: cone, once
agiilnt: intagli, tailing
agiilnn: alining, nailing
'aahhoprs: Pharaoh's, pharaoh's
ceellno: Colleen, colleen
ceiinss: iciness, incises
aainprst: aspirant, partisan
glnsu: lungs, slung
'eeeiimnprsssssv: impressiveness's, permissiveness's
'aamrsu: Amaru's, Maura's
'aamrst: Marta's, Tamra's
'''cefloss: fo'c's'les, fo'c'sle's
ilnstu: insult, sunlit
ghinoost: shooting, soothing
agntu: Gatun, gaunt
aegmnot: magneto, megaton, montage
ghiknt: Knight, knight
dhnosu: Hudson, hounds
aegmnrs: Germans, mangers
eiinprs: inspire, spinier
acdeelpr: parceled, replaced
eginprtu: erupting, reputing
'ins: In's, in's
agnrt: Grant, grant
agnry: angry, rangy
eehnorrstu: Southerner, southerner
agnss: sangs, snags
agnst: angst, gnats, tangs
'ims: MI's, mi's
deiooprst: depositor, droopiest
accdesuu: caduceus, caucused
'belosw: bowel's, elbow's
cdeeirst: discreet, discrete
'abemnssu: Sunbeam's, sunbeam's
aemrsstt: mattress, smartest
acehkls: hackles, shackle
agnor: argon, groan, organ
agiinprs: aspiring, praising
agnot: Tonga, tango
'adehlns: Handel's, handle's
beest: beets, beset
'ist: Ti's, it's, ti's
'isv: IV's, VI's
beert: Ebert, beret
cdeeirrt: directer, redirect
acelnru: nuclear, unclear
aeekortv: overtake, takeover
deeirsv: derives, diverse, revised
deeinprst: President, president
deeirss: desires, resides
aceeinpru: Epicurean, epicurean
cdeeeptx: excepted, expected
beelr: Berle, rebel
deinrssu: insureds, sundries
deeirrw: rewired, weirder
'acceinos: cocaine's, oceanic's
deeirrs: Dreiser, serried
deeirrt: retired, retried, tireder
deinrstt: strident, tridents
'deirrs: drier's, rider's
'deirsv: diver's, drive's
aeelstz: teazels, teazles
addeegnr: deranged, gardened
'aelnpst: planet's, platen's
acgiklns: calkings, slacking
'eghinrrs: Herring's, herring's
ceeiprsst: precisest, tricepses
aceens: Seneca, encase
'aefmnors: Foreman's, foreman's
'ddesy: Eddy's, eddy's
aceeps: escape, peaces
ehorst: others, throes
ehorss: horses, shores
ehorsw: shower, whores
ehorsv: hovers, shrove
'abeirssty: bestiary's, sybarite's
alostuy: layouts, outlays
ennotw: Newton, newton
ceipss: Pisces, spices
ennost: sonnet, tenons, tonnes
acnnot: Canton, cannot, canton
agmno: among, mango
bgilnow: blowing, bowling
acnnno: Cannon, cannon
'adlnsy: Dylan's, Lynda's
eeeilrst: leeriest, sleetier, steelier
deehnorst: dethrones, shortened
bbcelors: clobbers, cobblers
ffist: stiff, tiffs
acelosv: alcoves, coevals
acelost: lactose, locates
'noss: Son's, son's
ceglnoo: Cologne, cologne
'nosw: now's, won's
egilmnooss: gloominess, neologisms
loops: loops, pools, sloop, spool
'abehimnos: Bohemian's, bohemian's
aeelrss: resales, sealers
aeelrsv: reveals, several
aeelrst: realest, relates
aeeinnoprstt: penetrations, presentation
loost: loots, stool, tools
adeefilrst: Federalist, federalist
ehiknrt: rethink, thinker
befir: brief, fiber
'aelnors: Elanor's, Elnora's, Lenora's, Lorena's, loaner's
biimn: Mbini, nimbi
'degilrs: girdle's, glider's
bnosu: bonus, bosun
acnoor: corona, racoon
bilmo: Mobil, limbo
'cenorstu: counter's, recount's
billy: Billy, billy
acehmrs: Marches, marches
acehmrr: charmer, marcher
'ceeiprs: Pierce's, recipe's
acnort: Cantor, Carnot, cantor, carton
acnors: Carson, acorns
acnory: Cyrano, crayon
bnorw: Brown, brown
bnory: Bryon, Byron, Robyn
'ailmnopsy: Olympian's, palimony's
adeinrsst: Streisand, tardiness
egiimmnrs: immersing, simmering
ddey: Eddy, dyed, eddy
'aegmnrs: German's, manger's
aceeinnrt: ancienter, nectarine
aehmnors: horseman, menorahs
enrrtuu: nurture, untruer
aaceeinnrsss: Renaissances, renaissances
beglu: bugle, bulge
'egilnrsst: Sterling's, sterling's
'aailmns: Malian's, Manila's, animal's
'giilnqssu: Quisling's, quisling's
acelprs: carpels, parcels, placers, scalper
'goops: Pogo's, goop's
acelpsu: capsule, upscale
efhilms: Flemish, himself
accefiiinortt: certification, rectification
egiimnrt: meriting, mitering
addeeilr: deadlier, derailed
bilsy: Sibyl, Sybil, sibyl
'aamnns: Annam's, manna's
'dsstuy: Dusty's, study's
begin: Begin, begin, being, binge
ghost: Goths, ghost
acehlst: chalets, latches, satchel
deeg: edge, geed
adhnostu: handouts, thousand
deen: Eden, need
deep: deep, peed
deer: Reed, deer, reed
ghotu: ought, tough
acehlrs: Charles, larches
abdegirs: abridges, brigades
ceinst: incest, insect, nicest
agost: goats, togas
'adders: adder's, dread's
ceinpr: Prince, pincer, prince
ceiimorst: eroticism, isometric
ccikloy: cockily, colicky
ceinor: Corine, Enrico
adeilttu: altitude, latitude
demo: demo, dome, mode
'ehnrstu: Hunter's, hunter's
'aeimnors: moraine's, romaine's
dell: Dell, dell
delo: Dole, dole, lode
delw: lewd, weld
'belrsy: Beryl's, beryl's
deku: Duke, duke
alnost: Alston, Salton, talons
aadglnr: Garland, garland
deir: Reid, Ride, dire, ride
deis: dies, ides, side
deiv: Devi, dive, vied
deit: Tide, diet, edit, tide, tied
dein: Enid, dine
deil: deli, idle, lied
deim: Diem, dime
acehlor: cholera, chorale
dehi: hide, hied
'aeiprss: Persia's, praise's, spirea's
'agnost: Tonga's, tango's
'eglopss: Gospel's, gospel's
cddeeeeinnnp: Independence, independence
'aeiprrs: rapier's, repair's
defs: Feds, feds
'agnors: argon's, groan's, organ's
cefginorsu: configures, refocusing
'nrsu: run's, urn's
deoprst: deports, sported
derw: Drew, drew
deru: rude, rued
abeginrt: berating, rebating
dery: Dyer, dyer
'aaceirsv: avarice's, caviare's
aehhrsst: harshest, thrashes
enrstu: tuners, unrest
desu: Duse, dues, sued, used
deeefmnrt: deferment, fermented
denu: dune, nude
deno: Deon, done, node
dens: dens, ends, send
dent: dent, tend
denr: nerd, rend
deor: Oder, doer, redo, rode
deos: does, dose, odes
deot: dote, toed
eeeiimnprssssv: impressiveness, permissiveness
acggilnn: clanging, glancing
'aeeilmnnst: alinement's, lineament's
aceimpst: campiest, campsite
aceimpss: escapism, scampies
abdeginr: bearding, breading
adeilort: idolater, tailored
'ghilopsstt: spotlight's, stoplight's
deeimrt: demerit, merited, mitered
'ers: Er's, Re's, re's
adeilotv: dovetail, violated
acehnrst: chanters, stancher
'crsux: Crux's, crux's
'ess: SE's, Se's
cehiknst: kitchens, thickens
aeimortz: amortize, atomizer
ilopst: pilots, pistol, spoilt
'aerst: rate's, tare's, tear's
'deeinprsst: President's, president's
'aersv: Reva's, Vera's, rave's
'aersw: Ware's, ware's, wear's
'aersy: aery's, year's
acehopr: Pechora, poacher
agrsu: Argus, sugar
agrss: Grass, grass
'ens: NE's, Ne's
'egs: GE's, Ge's
'ehnors: Horne's, Rhone's, heron's
'ehs: He's, he's
acdeprs: redcaps, scraped
ehilrstw: Whistler, whistler
ceimsu: cesium, eMusic, miscue
ceorssu: Croesus, courses, sources, sucrose
ceorsst: corsets, escorts, sectors
ceorstv: coverts, vectors
'aceelnrsu: Laurence's, cerulean's
ghinoop: hooping, poohing
ghinors: horsing, shoring
'aceeiipprstt: peripatetic's, precipitate's
bellosw: Boswell, bellows
delmors: molders, smolder
aaailnrstu: Australian, Saturnalia
'aaceillprrst: Caterpillar's, caterpillar's
abcehlns: Schnabel, blanches
'nstu: nut's, tun's
deeinpr: Dnieper, ripened
aagilnv: Galvani, vaginal
akprss: Sparks, sparks
'nssu: Sun's, sun's
deimmsu: dummies, mediums
acelrst: cartels, clarets, scarlet
'egors: Roeg's, gore's, ogre's
'ehrstz: Hertz's, hertz's
illst: lilts, still, tills
illsw: swill, wills
illsy: silly, slily
deimmrt: midterm, trimmed
acehnsst: chastens, snatches, stanches
deeilpr: periled, replied
illps: pills, spill
'aegilnrst: integral's, triangle's
'aesst: East's, east's, seat's
'aessv: save's, vase's
deeilrv: deliver, relived, reviled
'aekosttu: outtake's, takeout's
'denorsw: downer's, wonder's
'aestt: Etta's, teat's
lostu: lotus, louts
'fms: FM's, Fm's
illms: Mills, mills
'elmrsty: Myrtle's, myrtle's
ghinst: nights, things
'cehorst: Hector's, hector's
'aainrsst: artisan's, tsarina's
acdeeimt: decimate, medicate
adginor: Gordian, adoring
'fhs: HF's, Hf's
'dgiinrs: Ingrid's, riding's
adginrw: drawing, warding
rssttu: struts, trusts
adginrt: darting, trading
ceilnu: Lucien, nuclei
ceilrs: relics, slicer
'aanss: NASA's, Sana's
aceenrrt: Terrance, recreant
beffrsu: buffers, rebuffs
aeijnn: Janine, Jannie
hrttu: Truth, truth
cdeoprru: procured, producer
'elorrs: Errol's, Lorre's
'elorsy: Elroy's, Leroy's
ehiirstt: shittier, thirties
egissttu: gustiest, gutsiest
adeilmst: medalist, misdealt
adeilmss: misdeals, misleads
'esx: Xe's, ex's
coops: coops, scoop
deeeloprv: developer, redevelop
eeknosty: keynotes, keystone
deimpru: dumpier, umpired
cdoort: Doctor, doctor
eeerrv: Revere, revere
'orsty: Tory's, Troy's, tyro's
'orstt: tort's, trot's
'orstu: rout's, tour's
eeersv: Reeves, reeves, severe
abinost: bastion, obtains
'aabcdeorrsst: broadcaster's, rebroadcast's
acdertu: Decatur, traduce
coost: coots, scoot
iinrtty: Trinity, trinity
aciintt: Titanic, titanic
'aamrs: Mara's, Rama's
ghilnstu: hustling, sunlight
adeeisstt: stateside, steadiest
aeimnr: Marine, airmen, marine, remain
ekost: stoke, tokes
eilmpst: limpest, limpets
deeiprs: Perseid, preside
'elossu: Seoul's, louse's
'elostw: owlet's, towel's
ekops: pokes, spoke
acehrst: archest, chaster
acehrss: chasers, crashes
aaahknrst: Astrakhan, astrakhan
'aehilss: Sheila's, Shelia's
adeilprs: lipreads, spiraled
ghilst: lights, slight
eehloprrstu: reupholster, upholsterer
adegiilmns: misdealing, misleading
coprs: corps, crops
bnrtu: brunt, burnt
bnrsu: Burns, burns
cimmnostu: Communist, communist
'ceinnnostt: Continent's, continent's
dennstu: dunnest, stunned
egginrstu: gesturing, grungiest
'ceefprst: perfect's, prefect's
adgilnu: languid, lauding
adgilnr: Darling, darling, larding
eiinors: ironies, noisier
hjnos: Johns, johns
'hos: Ho's, ho's, oh's
acistt: attics, static
ehoppr: Hopper, hopper
aaelnn: Leanna, anneal
aegimnrsu: geraniums, measuring
aegimnrst: emigrants, mastering, streaming
'firs: Fri's, fir's
egimnnort: Remington, mentoring
aeilss: Lassie, aisles, lassie
'aalrs: Alar's, Aral's, Lara's
'celrsu: lucre's, ulcer's
aeilrs: Israel, serial
aeilms: Ismael, Melisa, emails
aeilmr: Mailer, mailer
'aalms: Alma's, lama's
aeills: Sallie, allies
aeilnr: Arline, linear
'aalns: Alan's, Lana's
aeilnp: Alpine, Nepali, alpine
aeilns: aliens, alines, saline
eeglnst: Stengel, gentles
bbelrsu: burbles, lubbers
ggiinns: signing, singing
acdellops: collapsed, scalloped
'moorrsw: Morrow's, morrow's
aciillnoosst: colonialists, oscillations
ekpsy: Skype, pesky
'aepst: Pate's, pate's, peat's, tape's
'aeprs: Earp's, pear's, rape's
abcehmrs: Chambers, chambers
'celnosy: Ceylon's, Conley's
degimnrru: demurring, murdering
eimorst: moister, mortise
acemrs: creams, scream
'accems: Mecca's, mecca's
egoprrsu: groupers, regroups
aptty: Patty, patty
deeersv: deserve, severed
eeiprrs: reprise, respire
gimnoor: mooring, rooming
mnor: morn, norm
mnoo: Moon, mono, moon
'eirstttw: Twitter's, twitter's
ceiist: cities, iciest
deioprsv: disprove, provides
'bssu: UBS's, bus's, sub's
'adelors: loader's, ordeal's
'bstu: Btu's, tub's
abeiinrs: Siberian, binaries
cdeikrr: Derrick, derrick
eemorst: meteors, remotes
ceiikr: Rickie, ickier
acenos: canoes, oceans
delrstu: rustled, strudel
elosstu: lotuses, tousles
'emnoors: Monroe's, Moreno's
acenrt: Cretan, canter, nectar, recant, trance
acenrv: cavern, craven
ghinnorsu: onrushing, unhorsing
acenst: ascent, enacts, stance
iloss: Solis, silos, soils
acelpr: carpel, parcel, placer
acelst: castle, cleats
acelrt: cartel, claret, rectal
'eehnorrsstu: Southerner's, southerner's
deehhprs: Shepherd, shepherd
addeeprt: departed, predated
addeeprv: depraved, pervaded
'gipssy: Gipsy's, gipsy's
ghirtw: Wright, wright
'aceimnrs: Carmine's, carmine's
abeertt: Beretta, abetter
gimnpsu: impugns, spuming
deippr: Dipper, dipper, ripped
ajnstu: jaunts, juntas
ghirst: girths, rights
abeerst: beaters, berates, rebates
'ciprss: crisp's, scrip's
deiprs: prides, spider
'aeensst: Senate's, sateen's, senate's
aeklrst: stalker, talkers
egiipss: Gipsies, gipsies
'aenrsv: Verna's, raven's
'iiksw: kiwi's, wiki's
ilpss: lisps, slips
ilpst: spilt, split
'brsu: bur's, rub's
'oprsstu: Proust's, sprout's, stupor's
'ehirss: Sheri's, shire's
ceeinnss: incenses, niceness
''bnoss: bo's'ns, bos'n's
aceipsst: escapist, spaciest
'aaenpsst: anapest's, peasant's
'aegmnost: magneto's, megaton's, montage's
alpsy: palsy, plays, splay
eegilnps: peelings, sleeping
eegilnrv: levering, reveling
dgilloow: Goodwill, goodwill
deiorrstt: distorter, torridest
eegilnst: gentiles, sleeting, steeling
bnoors: Osborn, Robson
'aefkrs: faker's, freak's
cdeeilns: declines, licensed, silenced
eeipppr: peppier, preppie
aiopstu: Utopias, utopias
eforst: Forest, Foster, forest, fortes, foster, softer
hrstu: Hurst, Thurs, hurts
'ehinrs: Henri's, Rhine's
aghns: gnash, hangs
aghno: Hogan, hogan
aceenprrt: Carpenter, carpenter
emprsttu: strumpet, trumpets
accem: Mecca, mecca
acilopst: Capitols, capitols
'adelrrs: Darrel's, larder's
mpsu: sump, umps
'cdeeirsttu: certitude's, rectitude's
deistu: duties, suited
'deilss: sidle's, slide's
deissu: disuse, issued
aeklnst: anklets, lankest
cdeiins: incised, indices
behilrt: Hilbert, blither
'aimnsst: mantis's, matins's
acinot: action, cation
'deehhprss: Shepherd's, shepherd's
ainrst: strain, trains
aeghinrs: hearings, shearing
eeenrv: evener, veneer
aeinprrst: terrapins, transpire
aeeimnnorstu: enumerations, mountaineers
'adhrsy: Hydra's, hydra's
'eenprsst: present's, serpent's
acelns: cleans, lances
acelov: alcove, coeval
alsuu: luaus, usual
acelor: Carole, Oracle, oracle
'aclpss: clasp's, scalp's
acellr: caller, cellar, recall
alsst: lasts, salts, slats
acelms: camels, mescal
acelmr: Marcel, calmer
acdeerrt: cratered, retraced, terraced
ainnost: anoints, nations
acdir: Dirac, acrid
acdehnstu: staunched, unscathed
dghiins: dishing, shindig
eejrssy: Jerseys, jerseys
'ehlsstu: hustle's, sleuth's
deilnssw: swindles, wildness
abbeist: babiest, tabbies
'abelmrs: marble's, ramble's
deilnstu: insulted, unlisted
acdny: Candy, candy
aennstt: tannest, tenants
eehnorrsstu: Southerners, southerners
adeilpsttu: platitudes, stipulated
moss: Moss, moss
most: most, toms
'mosss: Moss's, moss's
acdep: caped, paced
acder: arced, cadre, cared, cedar, raced
acdel: decal, laced
acden: caned, dance
acdeg: cadge, caged
acdef: decaf, faced
deirrs: driers, riders
'deipprs: Dipper's, dipper's
acdet: acted, cadet
moor: Moor, Moro, moor, room
dfgilnnou: foundling, unfolding
mopr: prom, romp
ceorrss: crosser, scorers
deirst: direst, driest, stride
deirsv: divers, drives
'aenpss: Aspen's, aspen's
'eorstt: otter's, torte's
aekosttu: outtakes, stakeout, takeouts
hnors: horns, shorn
hnort: North, north, thorn
adeeinprt: pertained, repainted
ainsty: sanity, satiny
ainstt: taints, titans
ainstu: Austin, Unitas
ainsst: saints, stains
deiopsst: deposits, topsides
'ehosssttuw: Southwest's, southwest's
'cimmnosstu: Communist's, communist's
'ainopstu: Utopian's, utopian's
'aagls: alga's, gala's
'ainopsss: Passion's, passion's
ilnos: lions, loins
cenorstu: construe, counters, recounts, trounces
'aclors: Carlo's, Carol's, carol's, coral's
eggilrsw: wigglers, wriggles
'aeefmnrs: Freeman's, freeman's
adeegnru: dungaree, underage
adeegnrs: deranges, grandees, grenades
aabmnst: bantams, batsman
adeegnrr: gardener, garnered
'anorss: arson's, sonar's
eginorrst: resorting, restoring
'eorssw: sower's, worse's
bbelru: burble, lubber, rubble
'allmss: Small's, small's
'aagrs: agar's, raga's
'bnsu: bun's, nub's
acehl: Leach, leach
acehp: cheap, peach
acehs: Chase, aches, chase
aceht: cheat, teach
adiimnnoot: admonition, domination
aceil: Alice, Celia
hrtu: Ruth, Thur, hurt, thru
aceirr: Carrie, racier
'mps: MP's, PM's, Pm's
accehimsst: catechisms, schematics
acegr: Grace, grace
deimmr: dimmer, rimmed
'allssy: Sally's, sally's
gimnssu: musings, mussing
aceep: Peace, peace
acdeiiprst: patricides, pediatrics
deeinstt: dinettes, insetted
'filst: flit's, lift's
'eegils: Liege's, liege's
acepr: caper, crape, recap
aceps: capes, paces, space
aceilr: Claire, lacier
aceimn: anemic, cinema
'ammmnos: Mammon's, mammon's
aceimr: Crimea, Marcie, Mercia
aceno: canoe, ocean
acenr: Crane, crane, nacre
aeirstt: artiest, artiste, attires, tastier
aeirstw: waiters, wariest
acelr: Clare, clear
acels: laces, scale
aceln: Lance, clean, lance
acelm: Camel, camel
enrrtu: Turner, return, turner
acely: Alyce, Lacey
aeprrsy: prayers, sprayer
acems: Emacs, acmes, maces
hrsu: Rush, rush
'eforsst: Forest's, forest's
bhiiinooprt: Prohibition, prohibition
eehnorw: Erewhon, nowhere, whereon
efgiinnr: infringe, refining
acilnu: Alcuin, Lucian
almny: Lyman, manly
aginprt: parting, prating
aginprs: parings, parsing, rasping, sparing
acilsv: Slavic, Vlasic, cavils
ceeinorst: erections, secretion
aefinrss: fairness, sanserif
ehikrss: shrieks, shrikes
acesu: cause, sauce
aprsst: sprats, straps
deflnoruw: underflow, wonderful
'adeinrssst: Streisand's, tardiness's
acerv: carve, crave
'aafghns: Afghan's, afghan's
acert: caret, cater, crate, react, recta, trace
acers: Cesar, acres, cares, races, scare
binru: Rubin, bruin
aceeghllnr: Challenger, challenger
aegmoprrrs: programers, reprograms
almsu: alums, mauls
egiimps: Pigmies, pigmies
'bors: Rob's, orb's
binor: Robin, robin
eefls: feels, flees
eeelsv: levees, sleeve
almor: molar, moral
'mss: MS's, Sm's
'mst: MT's, Tm's
'aadeginrs: drainage's, gardenia's
ilstt: stilt, tilts
almps: lamps, palms, psalm
almpy: amply, palmy
aaghhins: Shanghai, shanghai
'moprs: prom's, romp's
ilsst: lists, silts, slits
aeeglnrs: enlarges, generals
'nrs: RN's, Rn's
hilops: Polish, polish
acehrt: Cather, Thrace
acehrs: arches, chaser, search
acehst: Scheat, chaste, cheats, sachet
acehss: cashes, chases
eefrs: frees, reefs
cgiiklns: lickings, slicking
eefrr: freer, refer
aeginrrstt: registrant, restarting
deiinrsst: dirtiness, disinters
hilosw: lowish, owlish
'gimnssu: Mingus's, musing's
'gorsy: gyro's, orgy's
deillt: lilted, tilled
aforrw: Farrow, farrow
aeirrst: artsier, tarries
acehir: Archie, achier
aadeiprs: Paradise, paradise
eemrst: merest, meters
acfrt: Craft, craft
hstu: huts, shut, thus, tush
acehms: sachem, schema
cdeefiirt: certified, rectified
aaceirv: avarice, caviare
ghint: night, thing
acimos: Mosaic, mosaic
'eginrss: signer's, singer's
airsst: sitars, stairs
airstt: artist, strait, traits
ghirt: girth, right
ceeinrsu: insecure, sinecure
enorrstuv: overturns, turnovers
bdegirs: Bridges, bridges
adeeimnnost: denominates, emendations
eegil: Liege, liege
aosstt: stoats, toasts
'eghhist: eighth's, height's
deilms: misled, smiled
deilmp: dimple, limped
allsw: Walls, walls
eehloprrsstu: reupholsters, upholsterers
allsy: Sally, sally
addegimnn: demanding, maddening
agims: agism, sigma
eiqrsu: quires, squire
deilps: dispel, lisped
agilr: Grail, grail
deilos: Isolde, oldies, soiled
allms: Small, malls, small
deilrs: idlers, slider
deilrw: Wilder, wilder
'eeimnsss: Nemesis's, nemesis's
'agrssu: Argus's, sugar's
'fosx: Fox's, fox's
ddeiltu: Luddite, diluted
alloy: alloy, loyal
allot: allot, atoll
deiltt: tilted, titled
deilss: sidles, slides
deilst: idlest, listed, silted, tildes
'aaclrs: Carla's, Clara's
eegnr: Green, genre, green
elrstu: Ulster, luster, lustre, result, rustle
aceiinottx: excitation, intoxicate
acgir: Craig, cigar
deiort: editor, rioted
'msstu: Tums's, must's, smut's
'aeeimnnorstu: enumeration's, mountaineer's
deiopr: dopier, period
acegny: Cagney, agency
abceilnprsu: Republicans, republicans
denorstu: roundest, tonsured
'aeoprsssv: Passover's, overpass's
acegir: Gracie, cagier
aprst: parts, sprat, strap, tarps, traps
aprsw: warps, wraps
aprss: rasps, spars
aprsy: prays, raspy, spray
bghirt: Bright, bright
acginnopy: canopying, poignancy
'belorsw: blower's, bowler's
aeginrs: erasing, regains, searing
aeginrr: angrier, earring, rangier, rearing
aeginrt: granite, ingrate, tangier, tearing
ceelorst: electors, selector
alorv: Orval, valor
'adeehilprss: dealership's, leadership's
alory: Royal, royal
alors: orals, solar
bbeils: Bibles, bibles
aeginst: seating, teasing
'aadns: Adan's, Dana's
ijnoru: Junior, junior
alops: Alsop, opals
loopss: sloops, spools
acehilm: Michael, Micheal
aglos: Lagos, goals
acehimr: Chimera, chimera
aglno: Anglo, Golan, Logan, along
'acegnsy: Cagney's, agency's
alosv: ovals, salvo
acdeenrt: cantered, decanter, recanted
aeilmoqsttu: Milquetoast, milquetoast
'aelnrst: antler's, rental's
aginrst: ratings, staring
agllo: Algol, Gallo
efghirst: fighters, freights
'adehrst: dearth's, hatred's, thread's
'aeimnrst: minaret's, raiment's
aglss: Glass, glass, slags
aeginnt: anteing, antigen, gentian
aeginnr: earning, grannie, nearing
ainnot: Nation, anoint, nation
'eeloprssty: polyester's, proselyte's
belmrstu: stumbler, tumblers, tumbrels
achin: China, Icahn, chain, china
eilrssv: silvers, slivers
deinno: Dionne, Donnie
deinnt: dentin, indent, intend, tinned
deinns: Dennis, sinned
eilrstt: litters, slitter
deinos: Edison, noised
deinor: Indore, ironed
achks: hacks, shack
cghikno: choking, hocking
achmo: macho, mocha
achmr: March, charm, march
'belnos: Noble's, noble's
achno: Cohan, nacho
aaceghnor: Anchorage, anchorage
achor: Roach, Rocha, roach
achoo: Ochoa, achoo
achpt: chapt, patch
ainsstu: Austins, sustain
'ehikst: Keith's, Kieth's
achrs: chars, crash
aaeilnorst: rationales, senatorial
apsty: Patsy, pasty, patsy
achty: Cathy, yacht
apssw: swaps, wasps
apsst: pasts, spats
'bdeorstu: doubter's, redoubt's
eiinopstt: petitions, pointiest
cdeinrs: cinders, discern, rescind
aegimns: enigmas, gamines, seaming
aegimnr: mangier, reaming
aacelmr: Carmela, caramel
aacelmn: Alcmena, manacle
alnnu: Luann, annul
aegimrt: Maigret, migrate, ragtime
alnos: Sloan, loans, salon
alnot: Alton, talon, tonal
bdegglo: blogged, boggled
aacellp: Capella, Laplace
aginstt: stating, tasting
aginsty: Stygian, staying
eilmpsst: misspelt, simplest
aeiinrr: Rainier, rainier
'moors: Moor's, moor's, room's
deinru: inured, ruined
deinrs: Snider, diners, rinsed, snider
deintu: united, untied
deinsy: Disney, Sidney
deinsu: indues, undies
aginsss: assigns, sassing
ersttu: truest, utters
einorssu: neurosis, resinous
'adst: DAT's, Tad's, tad's
erstuu: suture, uterus
aegillps: pillages, spillage
ceinorr: Corrine, cornier
ceinors: Ericson, cronies
'adinrs: Darin's, Indra's, Randi's, drain's, nadir's
ceinost: notices, section
'ailrsu: Lauri's, Luria's
'ailrst: trail's, trial's
'adinsv: divan's, viand's
defgit: fidget, gifted
'aforrsw: Farrow's, farrow's
aemppr: mapper, pamper
'eilmss: Selim's, slime's, smile's
acmps: camps, scamp
acmor: Marco, carom, macro
aflmrsu: armfuls, armsful
cdeiimmnooss: commissioned, decommission
cdeiinorst: directions, discretion
denrsu: nursed, sunder
'alostuy: layout's, outlay's
'aeelmnsss: lameness's, maleness's
aclsu: Claus, Lucas
dhlopsu: holdups, upholds
'aeeilnnstv: Valentine's, valentine's
aceinnoorstv: conservation, conversation
eimprstu: impurest, stumpier
aclry: Carly, Lycra
aclps: claps, clasp, scalp
acehhstt: hatchets, thatches
aaegtwy: gateway, getaway
'aalmnsu: alumna's, manual's
aainrst: Sinatra, artisan, tsarina
ceirrsu: cruiser, curries
inprst: Sprint, prints, sprint
'aegrrst: garret's, garter's, grater's
inprtu: Turpin, turnip
'beorsst: Osbert's, sorbet's, strobe's
deksy: dykes, skyed
'adms: dam's, mad's
'aers: Rae's, are's, ear's, era's
'asswy: sway's, yaws's
eeginrt: integer, treeing
'amnos: Mona's, Oman's, moan's
eeginrv: reeving, veering
'aesy: aye's, yea's
'eilnns: Lenin's, linen's
deipr: pride, pried
adegnrr: Gardner, grander
adegnrt: dragnet, granted
adegnrs: dangers, ganders, gardens
aegilmnr: germinal, malinger
behilprsu: publisher, republish
dddeil: diddle, lidded
deist: diets, edits, sited, tides
deisv: dives, vised
aaehilntv: Leviathan, leviathan
deirw: weird, wider, wired
deirv: Verdi, diver, drive
deirt: tired, tried
deirs: dries, rides, sired
deirr: direr, drier, rider
'eilnst: Intel's, inlet's
'amnsy: many's, myna's
ehlstu: hustle, sleuth
aceerrsty: Secretary, secretary
aeemnsttt: statement, testament
'ailsss: Silas's, sisal's
deity: Deity, deity
eeginss: Genesis, genesis, seeings
eoprs: pores, poser, prose, ropes, spore
'ailsty: Italy's, laity's
eoprt: Perot, trope
eopss: pesos, poses, posse
eopsx: expos, poxes
eopsy: Sepoy, poesy
deeelst: deletes, sleeted, steeled
aclms: calms, clams
imoprst: imports, tropism
deeelrv: levered, reveled
aclor: Carlo, Carol, carol, coral
aclos: coals, colas
ersstu: russet, surest
ersstw: strews, wrests
'aarstt: Tatar's, attar's
'asstw: WATS's, swat's
ackst: stack, tacks
ackss: casks, sacks
bdegsu: budges, debugs
accehst: cachets, catches
eefilr: liefer, refile, relief
bors: orbs, robs
abddeiors: broadside, sideboard
boss: boss, sobs
aklrsty: Krystal, starkly
acgiinnotu: auctioning, cautioning
egglrsu: gurgles, slugger
ehnorssu: onrushes, unhorses
bdeglu: bugled, bulged
'adilsv: Advil's, Vidal's
'aajnps: Japan's, japan's
'aels: Lea's, ale's, lea's
'aegrstt: Target's, target's
'befirs: brief's, fiber's
'ccdnoors: Concord's, concord's
'enrrstu: return's, turner's
'aaceeirrsstt: Secretariat's, secretariat's
'aeps: EPA's, ape's, pea's
'eilosv: Olive's, olive's, voile's
definr: finder, friend
mnotu: Mount, mount
'eilors: Loire's, Lorie's
deeenrrv: Reverend, reverend
defils: Fields, fields
mnoru: Munro, mourn
abdeerst: breasted, debaters
mnors: morns, norms
ehlrtu: Luther, hurtle
'aaginnosstt: antagonist's, stagnation's
defikn: finked, knifed
'eeenprsst: Petersen's, pretense's
dioprt: torpid, tripod
bgilnu: bluing, lubing
'aefrs: fare's, fear's
bgiillns: Billings, billings
'aefst: fate's, feat's, feta's
deeimmrs: immersed, simmered
'aaeilrsv: Valarie's, Valeria's
deeeirs: Desiree, seedier
aemnst: mantes, stamen
'ffgiinrs: Griffin's, griffin's
ackls: calks, lacks, slack
'aiopstu: Utopia's, utopia's
'aefls: flea's, leaf's
aemnor: Monera, enamor
demos: demos, domes, modes
bnsu: buns, nubs, snub
eimnopst: nepotism, pimentos
aeehrrs: hearers, shearer
cceknoy: Cockney, cockney
aeehrst: Theresa, heaters, reheats
aeehrtw: weather, whereat, wreathe
aeehrtt: theater, theatre
bnor: Born, Brno, born
bnoo: Bono, boon
'deenrsv: Denver's, vender's
'adgilnrs: Darling's, darling's
abddins: Sindbad, disband
ceinrst: cistern, cretins
cceehkrs: checkers, rechecks
'ijmmsy: Jimmy's, jimmy's
beglsu: bugles, bulges
celnooss: consoles, coolness
beglru: bugler, burgle
aborst: Strabo, aborts
acgiknr: arcking, racking
abberr: Barber, barber
acgikln: calking, lacking
'eghhinsss: Highness's, highness's
'flosw: flow's, fowl's, wolf's
ceinprs: pincers, princes
aegghiilnnt: Nightingale, nightingale
ddegilnu: deluding, indulged
efirssu: fissure, fussier
efirstu: fustier, surfeit
'ersstuu: suture's, uterus's
acehnrsuz: Schnauzer, schnauzer
adeelnrtu: unaltered, unrelated
ehnorsttw: Northwest, northwest
agilnps: lapsing, palings, sapling
agilnsv: salving, slaving
diqsu: quids, squid
agilnst: lasting, salting, slating, staling
abbeir: Barbie, babier
'josy: Joy's, joy's
aceennrst: entrances, renascent
bbgino: Gibbon, gibbon
abbels: Babels, babels
'eehprss: herpes's, sphere's
blru: Burl, blur
aaeiilnortz: rationalize, realization
bdeefir: briefed, debrief
bdeist: bidets, debits
'eemnsy: Yemen's, enemy's
denopr: Pernod, ponder
efginr: finger, fringe
ddenoru: redound, rounded
denosw: endows, snowed
nosty: Tyson, stony
'bbeils: Bible's, bible's
acimr: Marci, micra
denory: Rodney, yonder
'almnors: Marlon's, Molnar's, normal's
denors: drones, snored
'agls: gal's, lag's
denorw: Wonder, downer, wonder
'aegghiilnnst: Nightingale's, nightingale's
cceennort: connecter, reconnect
bdeirs: brides, debris
acins: Cains, Incas
acdelnor: Calderon, colander
aadeilstv: salivated, validates
acipr: Capri, carpi
acips: Spica, aspic
'ggiknos: gingko's, ginkgo's
'agss: gas's, sag's
elpssu: pluses, pulses
delru: lured, ruled
delsu: duels, slued
acitt: Attic, attic, tacit
'aekrsst: skater's, streak's
'belmrsu: lumber's, rumble's
aerrsstt: restarts, starters
eenrsstw: Westerns, westerns
delno: Eldon, olden
deloy: Doyle, yodel
delow: dowel, lowed
delos: doles, lodes, soled
delop: loped, poled
'abeirss: Serbia's, rabies's
bdeinr: binder, inbred, rebind
'agps: Gap's, gap's
deirstv: diverts, strived
'deeilstuy: Yuletide's, yuletide's
abdeirss: seabirds, sidebars
defsu: feuds, fused
bdeeils: Delibes, edibles
bdeeill: bellied, libeled
aceorstv: overacts, overcast
aceorsst: Socrates, coarsest, coasters
clnoo: Colon, colon
'adirsy: dairy's, diary's
belorsw: blowers, bowlers
belorst: bolster, lobster
eostv: stove, votes
ehlpps: Phelps, shlepp
ddeilnsw: dwindles, swindled
eegiknn: keening, kneeing
eegiknp: keeping, peeking
acginrv: carving, craving
acginrt: carting, crating, tracing
ddeilnps: spindled, splendid
adegiln: aligned, dealing, leading
acginsu: causing, saucing
'abeeknnrs: Banneker's, Bernanke's
ehlrstu: hurtles, hustler
iimnprst: imprints, misprint
deiilmt: delimit, limited
'ailnsv: Alvin's, anvil's
degir: dirge, ridge
degio: Diego, dogie
degil: gelid, glide
bdeortu: doubter, obtrude, redoubt
'eiprsst: Sprite's, priest's, sprite's, stripe's
'eisssu: Susie's, issue's
jstu: just, juts
blos: lobs, slob
blot: blot, bolt
'amnors: Moran's, Ramon's, Roman's, manor's
blow: blow, bowl
'cchksu: Chuck's, chuck's
'amnoss: Mason's, Osman's, mason's
deeps: deeps, speed
bjos: Jobs, jobs
deers: Seder, deers, reeds
deert: deter, treed
'aeginsu: Guinea's, guinea's
deesw: Swede, sewed, weeds
deetw: Tweed, tweed
'ehistw: White's, white's
acdellor: carolled, collared
abenrst: Barents, banters
addeelp: pedaled, pleaded
deewy: Dewey, weedy
aeenntt: Annette, Nanette
acprs: carps, craps, scrap
deeepst: deepest, steeped
eeinnrst: intenser, internes
deflnos: enfolds, fondles
akmnorw: Workman, workman
'acfiinnorst: infarction's, infraction's
aimnnos: Minoans, mansion
deels: Edsel, Leeds
addeest: deadest, sedated
'eggilns: leggin's, neglig's, niggle's
deens: Edens, dense, needs
eeinnrtt: Internet, internet
ceeilnost: elections, selection
'abders: Beard's, Debra's, beard's, bread's
cdeilmop: compiled, complied
ehlost: Lhotse, helots, hostel, hotels
'ailosv: Viola's, viola's
ehlosv: hovels, shovel
'eehrst: ether's, there's, three's
'eehrsw: hewer's, where's
defin: fiend, fined
defil: Fidel, field, filed, flied
defir: fired, fried
'eilsst: islet's, stile's
defiy: deify, edify
bdeeggru: begrudge, debugger
cehinopt: Pinochet, phonetic
eimnnrsttu: instrument, nutriments
closw: cowls, scowl
clost: clots, colts
addeehr: adhered, redhead
'accehimsst: catechism's, schematic's
'eemorst: meteor's, remote's
'abdeos: abode's, adobe's
'iinppps: Pippin's, pippin's
ggilnoss: glossing, goslings
'eimprsss: impress's, premiss's
'efginrs: finger's, fringe's
besty: Betsy, bytes
eefhrrs: fresher, refresh
'aegimns: enigma's, gamine's
acceips: icecaps, ipecacs
dioprst: disport, tripods
bins: bins, nibs
aeehnrt: Teheran, earthen, hearten
'aegimrs: Margie's, mirage's
bill: Bill, bill
acost: Tosca, ascot, coast, coats, tacos
acort: Croat, actor
acceino: cocaine, oceanic
ceginnortu: countering, recounting
'abst: bat's, tab's
abcdeemr: cambered, embraced
eoqtu: quote, toque
ceginnorsv: conserving, conversing
'abrs: bar's, bra's
deeemrt: Demeter, metered
dehrs: herds, sherd, shred
imprsu: Purims, purism
eegimnt: meeting, teeming
'eilswy: Wiley's, Wylie's
aegilnps: elapsing, pleasing
'abms: ABM's, MBA's
acilmnopt: complaint, compliant
aegilnst: genitals, stealing
aegilnsv: Svengali, leavings
dehor: Herod, Rhode, horde
dehos: hosed, shoed
acdnor: Conrad, Dacron, candor
'abls: alb's, lab's
aegilnrt: alerting, altering, integral, relating, triangle
aegilnrs: Salinger, slangier
aegilnry: layering, relaying, yearling
amorsy: mayors, morays
abddeer: bearded, breaded
deinw: Edwin, Wendi, widen, wined
deinx: index, nixed
deins: Denis, dines, snide
deims: deism, dimes
deimr: dimer, mired, rimed
deimn: denim, mined
deilt: tilde, tiled
deilv: devil, lived
deilw: Wilde, wield, wiled
derstu: duster, rudest, rusted
deilp: piled, plied
deils: delis, idles, sidle, slide
deilr: idler, riled
deilo: oiled, oldie
deiks: dikes, skied
acgillnor: carolling, collaring
dikss: disks, skids
giimnst: misting, smiting, timings
'abgs: bag's, gab's
'abds: bad's, dab's
ceehrst: Chester, etchers, retches
gghinsu: Huggins, gushing
cllsu: culls, scull
aamnoprtu: Paramount, paramount
cdnoors: condors, cordons
dhimoru: humidor, rhodium
bertu: brute, rebut, tuber
aaprst: Sparta, satrap
bhos: bosh, hobs
acnot: Acton, canto
berry: Berry, berry
acnno: Canon, Conan, canon
bersu: rebus, rubes
acnny: Nancy, canny
deeiprss: disperse, presides
abddeor: boarded, roadbed
beeorssv: observes, obverses
'aahkllmrs: Hallmark's, hallmark's
acnst: cants, scant
begrru: Burger, burger
'acst: act's, cat's
eortv: overt, voter
eortw: tower, wrote
eortt: otter, torte
eortu: outer, route
'acrs: RCA's, arc's, car's
'egginrs: Ginger's, ginger's, nigger's
deffir: differ, riffed
aaceinrst: Cartesian, ascertain, sectarian
aeemnsst: Massenet, tameness
adilrsz: Szilard, lizards
deglo: Lodge, lodge, ogled
eeforrst: Forester, forester, reforest
'adiors: Dario's, radio's
acdorw: Coward, coward
eegilnr: leering, reeling
bhsu: Bush, bush, hubs
eorss: roses, sores
eorsv: overs, roves, servo
eorsu: euros, rouse
eorsw: sower, swore, worse
'acinost: action's, cation's
eorrv: Rover, rover
'acps: CPA's, PAC's, cap's
addilmn: Midland, midland
acgillnops: collapsing, scalloping
eeoprssss: espressos, repossess
ekrtuy: Turkey, turkey
dehis: hides, shied
akrst: Stark, stark
aabhitt: Tabitha, habitat
acmry: Camry, Marcy
dilos: idols, solid
acmrs: crams, scram
acmsu: Camus, sumac
acehhrtt: Thatcher, thatcher
bdeeil: belied, edible
deffru: duffer, ruffed
addegln: dangled, gladden
bdeenr: Bender, bender
dilly: dilly, idyll
beffginru: buffering, rebuffing
aeenrst: Earnest, Eastern, earnest, eastern, nearest
'aelrs: Earl's, Lear's, earl's, real's
aehmss: mashes, shames
'aelsz: laze's, zeal's
'aelst: Leta's, tale's, teal's
'aelss: Elsa's, Lesa's, sale's, seal's
'aelsx: Alex's, axle's
'aelsv: Elva's, vale's, veal's
'aelsw: wale's, weal's
'aelps: leap's, pale's, peal's, plea's
aeeimrst: emirates, steamier
aehmrs: harems, masher
ciopst: optics, topics
aeflmorwy: Mayflower, mayflower
'ehkoorssuw: housework's, workhouse's
deelprsu: preludes, repulsed
'aciillnoosst: colonialist's, oscillation's
cdeinnotu: continued, unnoticed
deenrtu: denture, tenured
almtuu: mutual, umlaut
aeeinnortv: enervation, veneration
'efils: Leif's, file's, life's
deenrss: redness, senders
cceinors: conciser, cornices
deenrsu: endures, ensured
'lmpsu: lump's, plum's
'efins: Enif's, fine's
einpru: punier, unripe
'aelns: Lane's, Lean's, Lena's, Neal's, lane's, lean's
einprs: ripens, sniper
'hilopss: Polish's, polish's
'hnorst: North's, north's, thorn's
rstu: rust, ruts
'aells: Ella's, Lela's
adeiinnotw: Nationwide, nationwide
'aelms: Elma's, Male's, lame's, male's, meal's
einpst: instep, spinet
einpss: snipes, spines
bdenorsu: bounders, rebounds, suborned
adeinrst: randiest, strained
'ehrrssy: Sherry's, sherry's
aabdehhirrst: hairbreadths, hairsbreadth
bgru: burg, grub
aghorstw: Hogwarts, warthogs
adeinrtt: Andretti, nitrated
abghinorr: abhorring, harboring
'berstu: brute's, tuber's
'densu: dune's, nude's
aehnns: Hansen, hennas
'denos: Deon's, node's
aehnrt: Tehran, anther
aegmoprrr: programer, reprogram
'ehmors: Homer's, homer's
adehlnst: Shetland, Stendhal
bglo: blog, glob
aaimnr: Armani, Marian, Marina, airman, marina
bgos: bogs, gobs
dnosw: Downs, downs
dnosy: Dyson, synod
aeensst: Senates, senates
aehnsy: Haynes, hyenas
aehnst: Athens, hasten
aehnsv: havens, shaven
'ahoosy: Yahoo's, yahoo's
dnowy: Downy, downy
'aeksw: Wake's, wake's
'aekst: Kate's, take's, teak's
aeeimstt: estimate, meatiest
aacinnort: Carnation, carnation
einort: Orient, orient, tonier
einors: Senior, nosier, senior
eeinrtty: entirety, eternity
eirssst: Sisters, resists, sisters
aaegmnt: magenta, magnate
abcelmrs: clambers, scramble
'aekls: kale's, lake's, leak's
einops: opines, ponies
bellow: Bellow, Bowell, bellow
'ahirsst: Ishtar's, Trisha's
'aegirst: gaiter's, triage's
addinor: Android, android
egsstu: guests, gusset
'eeirsvw: review's, viewer's
'anoprst: patron's, tarpon's
'deors: Oder's, doer's
'accehimnss: mechanics's, mischance's
'benosy: Ebony's, ebony's
fhirst: firths, shrift
aailrt: Altair, lariat
bdeelrt: Delbert, trebled
'ehmnsy: Hymen's, hymen's
aailsv: avails, saliva
aailss: Alissa, assail
aehors: ashore, hoarse
efginrs: fingers, fringes
dnopu: Pound, pound
aailmn: Malian, Manila, animal
'acemnors: Cameron's, romance's
'aejprss: Jasper's, jasper's
ggiknos: gingkos, ginkgos
abdeeist: beadiest, diabetes
ciortv: Victor, victor
'adinors: Dorian's, inroad's
'erssu: ruse's, user's
aehknr: hanker, harken
'ceopss: Pecos's, copse's, scope's
eeinrstu: retinues, reunites
eeinrstv: nerviest, reinvest
'aenrs: Erna's, Rena's
'aenst: Etna's, Nate's, ante's
'aensv: Evan's, nave's, vane's
deefr: defer, freed
aaeimnnr: Annmarie, Armenian, Marianne
'aenps: Pena's, nape's, pane's
deegs: edges, sedge
deegr: edger, greed
ccikr: Crick, crick
deemrstu: demurest, mustered
acehrtt: chatter, ratchet
'effis: fief's, fife's
best: Best, best, bets
bert: Bert, Bret
acehrrst: Chartres, charters
eirsttt: titters, tritest
acsst: casts, scats
'acnorst: Cantor's, cantor's, carton's
bell: Bell, bell
belo: bole, lobe
'acnorsy: Cyrano's, crayon's
belu: blue, lube
beor: Boer, Ebro, bore, robe
'aaceeinnrsss: Renaissance's, renaissance's
abcdeirs: ascribed, carbides
deinorssw: rowdiness, wordiness
beir: Brie, bier
aaikmt: Katmai, Tamika
aehlmt: Hamlet, Thelma, hamlet
aehlmr: Harlem, Mahler
'amsss: Mass's, mass's
'aagnors: Angora's, angora's
been: Eben, been
beors: Boers, bores, robes, sober
begr: Berg, berg
'elorsuv: Louvre's, louver's, velour's
aehlst: Thales, halest, lathes
aehlss: hassle, lashes
aehlsw: whales, wheals
aehlsy: Ashley, Halsey
aehimss: Messiah, messiah
'aemrs: Erma's, mare's, ream's
'aemss: mesa's, seam's
'aemst: mate's, meat's, team's
bdeeors: bedsore, sobered
aehlrt: halter, lather
celmnos: Clemons, Clemson
'aelnrstu: Laurent's, Renault's, neutral's
aeersst: Easters, teasers
'aemns: mane's, mean's, name's
aaegsv: Savage, savage
adeeeglrsv: Everglades, everglades
cchku: Chuck, chuck
'aeknss: Snake's, snake's, sneak's
bdsu: buds, dubs
accenrs: Cancers, cancers
acehrstt: chatters, ratchets
aelmprt: Templar, trample
bdoy: Boyd, body
adeirstt: striated, tardiest
bdno: Bond, bond
'eeiloss: Eliseo's, Eloise's
'aeinrrst: terrain's, trainer's
acrss: crass, scars
ceijstu: Justice, justice
aaegln: Angela, galena
aaegmn: Meagan, manage
'eejrssy: Jersey's, jersey's
bdir: Bird, bird
aceorrst: creators, reactors
aehmnr: Arnhem, Herman
epsstu: setups, upsets
giiknrst: skirting, striking
benor: boner, borne
benoy: Ebony, boney, ebony
bdes: Debs, beds, debs
cenors: censor, crones
'aekmrs: Merak's, maker's
ceikorst: rockiest, stockier
gginor: goring, gringo
'adiils: Iliad's, Lidia's
aelmnst: laments, mantels, mantles
aceinost: aconites, canoeist
aceinort: Creation, creation, reaction
'ikrss: Kris's, risk's
belsu: blues, lubes
belst: belts, blest
aainnrv: Nirvana, nirvana
belru: bluer, ruble
belry: Beryl, beryl
'adeems: Medea's, edema's
aadeilpss: Palisades, palisades
eehoorsvw: howsoever, whosoever
belos: boles, lobes
below: below, bowel, elbow
belno: Nobel, Noble, noble
'chmsu: chum's, much's
cefgiinrty: certifying, rectifying
'aehst: Thea's, hate's, heat's
aabcdkrw: backward, drawback
'acorsst: Castor's, castor's, costar's
aehrst: Hearst, earths, haters, hearts
aehrss: rashes, shares, shears
aehrsw: hawser, washer
aehrtt: hatter, threat
'ehlorsst: holster's, hostler's
'aehrs: Hera's, hare's, rhea's
aehrty: earthy, hearty
deeegnr: greened, reneged
'acdeinoorst: coordinate's, decoration's
bceu: Cebu, cube
bcek: Beck, beck
cefiilty: Felicity, felicity
'dersy: Dyer's, dyer's
'aagjrsu: Jaguar's, jaguar's
ablopyy: Playboy, playboy
aelrssv: salvers, slavers
belopu: Pueblo, pueblo
aillorstt: littorals, tortillas
belosw: bowels, elbows
bcku: Buck, buck
aelrstv: travels, varlets
aelrstt: rattles, starlet, startle
belorw: blower, bowler
aelrstw: Walters, wastrel
ceirsu: Cruise, cruise, curies
aehrrt: Rather, rather
adeenrstu: denatures, sauntered
acemprs: campers, scamper
eghnoruv: hungover, overhung
'opst: pot's, top's
'abdors: board's, broad's
'opss: SOP's, sop's
aeehhrt: Heather, heather
acdeinoort: coordinate, decoration
eghiilnrs: hirelings, relishing
'aelmprst: Templar's, trample's
adeeilmnrst: derailments, streamlined
aceinnst: ancients, canniest, instance
bdeknu: bunked, debunk
'eorrsst: resort's, roster's, sorter's
'alorsv: Orval's, valor's
'aaeglns: Angela's, galena's
'aerrsstt: restart's, starter's
enorsw: owners, worsen
enorst: Nestor, Sterno, tenors, tensor
enorss: sensor, snores
hhnoorrst: Shorthorn, shorthorn
egimnpt: pigment, temping
'aegls: Gael's, Gale's, gale's
adegrty: gyrated, tragedy
knpsu: punks, spunk
'aegps: gape's, page's
gghiins: Higgins, sighing
adegrrs: graders, regards
deeehlw: wheedle, wheeled
'aegrs: gear's, rage's
'aegss: Sega's, sage's
'amrsy: Mary's, Myra's, army's
'amrst: mart's, tram's
eejrsy: Jersey, jersey
deflow: flowed, fowled, wolfed
einstu: iTunes, unites, unties
deflno: enfold, fondle
'cdeors: credo's, decor's
einsst: insets, steins
einssw: sinews, swines
deiistt: ditties, tidiest
eeghinst: seething, sheeting
'bbnoorsu: Bourbon's, bourbon's
aacelnrst: Lancaster, ancestral
ceistv: civets, evicts
eeghinrs: greenish, sheering
accersu: accrues, accuser
enrrstu: returns, turners
eeloprsty: polyester, proselyte
belmru: lumber, rumble
beglrsu: buglers, burgles
'amnstuu: Autumn's, autumn's
aaegrsv: ravages, savager
'egorsu: rogue's, rouge's
aainpst: Antipas, patinas
acinnost: contains, sanction
gmpyy: Pygmy, pygmy
'abmnosw: Bowman's, bowman's
eeilnosss: lionesses, noiseless
defmor: deform, formed
aehpss: phases, shapes
abdeeerv: beavered, bereaved
'dlors: Lord's, lord's
aehprs: Sharpe, Sherpa, phrase, seraph
aemrst: master, stream, tamers
aemrsu: Maseru, Mauser
aemrss: Ramses, smears
'amost: atom's, moat's
acemnor: Cameron, romance
einrst: insert, inters
einrss: resins, rinses, sirens
ceehils: helices, lichees
einrsu: insure, inures
aeghilnrst: earthlings, slathering
aceehrt: cheater, hectare, teacher
beirt: Tiber, tribe
begins: begins, beings, binges
aaegssu: assuage, sausage
'celorstu: Coulter's, cloture's
aceehls: Chelsea, leaches
egimpsy: Pygmies, pygmies
'egosuv: Vogue's, vogue's
ahorstu: Suharto, authors
egiint: ignite, tieing
adeeimnoprst: impersonated, predominates
abddeiorss: broadsides, sideboards
'beefginrrssttu: Butterfingers's, butterfingers's
ellovy: lovely, volley
cddeeirt: credited, directed
defnor: Fronde, fonder
eeinprsstt: persistent, prettiness
eehmnoorsw: homeowners, horsewomen
bggilnu: bugling, bulging
acinotu: auction, caution
aemsss: Masses, masses
'iinrstty: Trinity's, trinity's
aemssu: amuses, assume
'ceorstv: covert's, vector's
acinost: actions, cations
acinoss: caisson, casinos, cassino
acinopt: Pontiac, caption
deeinrsst: dissenter, residents, tiredness
eeghilnw: Wheeling, wheeling
aemstt: mattes, tamest
'ceorsst: Cortes's, corset's, escort's, sector's
'ceorssu: Crusoe's, course's, source's
'acnoors: corona's, racoon's
eoqstu: quotes, toques
aillortt: littoral, tortilla
bdenru: burden, burned
'adnors: Drano's, NORAD's, Ronda's, radon's
ceeginptx: excepting, expecting
kooty: Kyoto, Tokyo
'adiimnnoost: admonition's, domination's
ilnost: Liston, tonsil
accehmno: Comanche, coachmen
ehilstt: lithest, thistle
deinors: indorse, rosined
airsstt: artists, straits
cenrsstu: curtness, encrusts
ahstw: swath, thaws, whats
'ostw: tow's, two's
aacghillpry: calligraphy, graphically
'cceilrs: circle's, cleric's
'admnos: Damon's, nomad's
degiinrs: desiring, residing, ringside
aanprst: Spartan, spartan
'dnossy: Dyson's, synod's
abcekrst: backrest, brackets
anruwy: runway, unwary
'aeenrsst: Earnest's, earnest's
aehnorstt: Northeast, northeast
'addlnoosw: download's, woodland's
'efrsy: Frey's, Frye's
ehoorst: Hooters, hooters, shooter
aceinrst: canister, scantier
'cikns: Nick's, nick's
aenrstu: natures, saunter
aenrstv: servant, taverns
'ggiinnss: signing's, singing's
aenrssw: answers, rawness
'cikrs: Rick's, rick's
aeqrsttu: quartets, squatter
deinnst: indents, intends
'adeelrs: dealer's, leader's
aesstttu: astutest, statutes
aarrstt: Tartars, tartars
cefinors: conifers, forensic
acerrst: craters, tracers
acehmrrs: charmers, marchers
'adrsy: dray's, yard's
'aaadmnrs: Narmada's, Ramadan's
'adrsw: draw's, ward's
aegllry: allergy, gallery, largely, regally
ahrst: harts, trash
denorst: rodents, snorted
denorsu: resound, sounder
denorsw: downers, wonders
denoruw: rewound, wounder
ahrry: Harry, harry
aginorsty: gyrations, signatory
eeerrssv: reserves, reverses
'deosssyy: Odyssey's, odyssey's
aadmrs: Madras, dramas, madras
girst: girts, grist, grits
aginorsst: assorting, organists
eeelprss: peerless, sleepers
'deers: Reed's, deer's, reed's
aabeiilnst: banalities, insatiable
'aenrrsw: Warner's, warren's
'adeiss: Sadie's, aside's
'cilos: Clio's, coil's
'deens: Eden's, need's
'cfhins: Finch's, finch's
aeemnssttt: statements, testaments
'cehrrsy: Cherry's, cherry's
ggikno: gingko, ginkgo
'adeils: Delia's, ideal's
'eprrssuu: pursuer's, usurper's
acersst: actress, casters, recasts
admnort: dormant, mordant
admnosy: Mondays, dynamos
'eiorss: Rosie's, osier's
'aegnors: Genaro's, orange's
'dikrs: Dirk's, dirk's
'dikss: disk's, skid's
acdeeimst: decimates, medicates
'chiksst: kitsch's, shtick's
'deils: deli's, idle's
acdefiiinot: deification, edification
'deims: Diem's, dime's
bekoor: Booker, Brooke
aclopsu: copulas, cupolas
eellprss: respells, spellers
aempprs: Pampers, pampers
'eoprsst: poster's, presto's
acddeent: decadent, decanted
ceenorssv: conserves, converses
efllru: Fuller, fuller
aadlnv: Vandal, vandal
'eils: lei's, lie's
'nrstu: runt's, turn's
'aehprss: Sharpe's, phrase's, seraph's
aeerrstu: austerer, treasure
aeelmnss: lameness, maleness, nameless, salesmen
aeerrssu: erasures, reassure
'abelrrsw: brawler's, warbler's
'eilrssv: silver's, sliver's
'adehss: Hades's, shade's
'cceehkrs: checker's, recheck's
egimrs: Grimes, grimes
beginrttu: buttering, rebutting
aceilmnsu: calumnies, masculine
aegiinnortt: integration, orientating
'beegrrs: Berger's, Gerber's
aaeinoprrt: Praetorian, reparation
'eilnpsu: lineup's, lupine's
aceeinnrst: nectarines, transience
'ikstty: Kitty's, kitty's
abeelstt: settable, testable
aceimnr: Carmine, Crimean, carmine
ggiilnnt: glinting, tingling
ggiilnns: singling, slinging
egiimnprs: premising, simpering
'eilnoss: insole's, lesion's
'orst: rot's, tor's
ehilrst: Hitlers, slither
'eoprrst: porter's, report's
'eilnors: Elinor's, Lenoir's
beknru: Bunker, bunker
aenprstt: patterns, transept
'achiinst: Chaitin's, Chianti's
aainrsst: artisans, tsarinas
aefflrs: Raffles, raffles
'adeinns: Dannie's, Dianne's, Nadine's
aceelorss: casserole, escaroles
eiimnrt: interim, mintier, termini
aghilmort: algorithm, logarithm
esstw: Wests, stews
ahpst: paths, staph
abeirrz: bizarre, brazier
giprs: grips, prigs, sprig
fglos: flogs, golfs
gipsy: Gipsy, gipsy
degiimnp: impeding, impinged
abeirtt: battier, biretta, terabit
ahprs: Sharp, harps, sharp
'ceelors: Creole's, creole's
enosst: onsets, stones
'ilsst: list's, silt's, slit's
eoprsstt: protests, spotters
enostx: Sexton, sexton
enostw: Townes, Weston
egilru: gluier, uglier
'aeersvw: Weaver's, weaver's
aefnsst: fastens, fatness
'cinos: coin's, icon's
lprsu: purls, slurp
'aeersst: Easter's, Teresa's, teaser's
arssty: satyrs, strays
'ddegrsu: Drudge's, drudge's
ceginorst: corseting, escorting
deeiirrsv: Riverside, riverside
beoprrsv: Proverbs, proverbs
deinsst: dissent, snidest
aerswy: Sawyer, sawyer
egiors: Sergio, orgies
egiort: goiter, goitre
'aegrst: Greta's, grate's, great's
'aaeimnnrs: Annmarie's, Armenian's
'aegrsz: gazer's, graze's
abeeginrv: beavering, bereaving
aersuz: Suarez, azures
'aeijnns: Janine's, Jannie's
aloprst: patrols, portals
aerstw: Waters, rawest, waster, waters
aeghinrstt: shattering, straighten
'arst: Art's, art's, rat's, tar's
'arsw: raw's, war's
aerstt: stater, taster, treats
'bglos: blog's, glob's
aerstu: Atreus, Seurat
aerstv: averts, starve, vaster
deinstt: dentist, stinted
deinsty: density, destiny
aersst: assert, asters, stares
cflpsuu: cupfuls, cupsful
eenrstw: Western, western
eenrstu: neuters, tenures, tureens
almors: molars, morals
egnrty: Gentry, gentry
'adeimns: maiden's, median's
ejlou: Joule, joule
'efnrs: Fern's, fern's
egilstu: gluiest, ugliest
'aeghnorsv: hangover's, overhang's
eehnnorrrt: Northerner, northerner
'adlos: Aldo's, load's
eilnsst: enlists, listens, silents, tinsels
'adensu: Auden's, Duane's
'adenss: Andes's, Sedna's, Snead's, sedan's
'ilnos: Olin's, lion's, loin's
lpsuu: Lupus, lupus
'egst: GTE's, get's
aeeilntttvy: attentively, tentatively
chiks: Hicks, hicks
'adenrs: Andre's, Daren's
aaegilr: Algeria, regalia
'egos: Geo's, ego's
ailmpsst: palmists, psalmist
deerst: desert, deters, rested
deersv: served, versed
'egps: Peg's, peg's
abeilor: Alberio, Albireo
abeillr: Braille, braille, liberal
belorsst: bolsters, lobsters
celnoos: colones, console
'egks: EKG's, keg's
abeilmr: Maribel, balmier
'egls: gel's, leg's
'egms: Meg's, gem's
'dinos: Dino's, Dion's, Odin's
eginor: ignore, region
eeprsst: pesters, presets
eeprssu: Perseus, peruses
'begilnsss: blessing's, glibness's
eginst: ingest, signet, tinges
eginss: gneiss, singes
aadiln: Dalian, Danial
'abilrs: Blair's, Libra's
eginrw: Wigner, winger
eginrs: Ingres, Singer, reigns, resign, signer, singer
bdestu: busted, debuts
eginrr: erring, ringer
belsstu: bustles, sublets
'agghiiknnsstv: Thanksgiving's, thanksgiving's
'aeprsstu: Pasteur's, pasture's
bmoos: booms, bosom
'bbceklorsstu: Blockbuster's, blockbuster's
deinrtu: intrude, untried
deinrtt: Trident, trident
'adefilnost: deflation's, defoliant's
cceennorst: connecters, reconnects
adghins: dashing, shading
'adeilns: Daniel's, denial's
'illsy: Lily's, lily's
'aeghnopst: heptagon's, pathogen's
'illst: lilt's, till's
'illsw: Will's, will's
'achimnosst: Macintosh's, macintosh's
'aacelmns: Alcmena's, manacle's
ehilost: holiest, hostile
almpss: Psalms, psalms
aeerrsw: swearer, wearers
abeirstt: birettas, terabits
abeirsty: bestiary, sybarite
'ilmos: Milo's, limo's
'abdeirss: seabird's, sidebar's
elmmpstu: plummest, plummets
'deiss: ides's, side's
'deist: Tide's, diet's, edit's, tide's
'deisv: Devi's, dive's
acdeeefnort: Confederate, confederate
hosstu: Souths, shouts
clostu: clouts, locust
'korsy: Kory's, York's
'eiklnsw: Winkle's, welkin's
aehils: Elisha, Sheila, Shelia
aeoprssv: Passover, overpass
aacnpst: capstan, catnaps
'ehlppss: Phelps's, shlepp's
'aeksst: skate's, stake's, steak's
fnostu: founts, futons
ceoprrrsu: precursor, procurers
aenoopsst: soapstone, teaspoons
'aacelmrs: Carmela's, caramel's
'aissv: Siva's, Visa's, visa's
'demos: demo's, dome's, mode's
'adells: Della's, ladle's
imnos: Minos, Simon
imnot: Minot, Timon
imnor: Morin, minor
adeimrrs: admirers, marrieds
aceirrr: Carrier, carrier
aceirrs: carries, scarier
aceirrt: Cartier, erratic
adeimrss: misreads, sidearms
'aegprs: grape's, pager's
'ilpss: lisp's, slip's
chkos: hocks, shock
abbdels: dabbles, slabbed
iiksw: kiwis, wikis
'eflsu: flue's, fuel's
'eflst: felt's, left's
'cdeeinoprsv: Providence's, providence's
'adelsy: Daley's, delay's
'cefhis: chief's, fiche's
'eesw: ewe's, wee's
'eesv: Eve's, eve's
chksu: Kusch, shuck
'adnsw: Dawn's, dawn's, wand's
aehhst: heaths, sheath
'eels: Lee's, eel's, lee's
beilrst: blister, bristle
'aswy: way's, yaw's
ddeeinnt: indented, intended
achrst: charts, starch
'aceeghllnrs: Challenger's, challenger's
'aeehhrst: Heather's, heather's
eflorw: Fowler, flower
'elnnsy: Lenny's, Lynne's
afillpsu: pailfuls, pailsful
'anpssy: Pansy's, pansy's
'delos: Dole's, dole's, lode's
imost: moist, omits
'astv: VAT's, vat's
aerrst: Sartre, arrest, rarest, raster
adilnors: Rosalind, ordinals
'beknrsu: Bunker's, bunker's
'dells: Dell's, dell's
cegnorss: Congress, congress
'iloss: Lois's, silo's, soil's
gilnos: lingos, losing, soling
'adors: Dora's, road's
gilnop: loping, poling
'aeinprs: Napier's, panier's, rapine's
'aiinnorstu: ruination's, urination's
'eilnsst: listen's, silent's, tinsel's
almnor: Marlon, Molnar, normal
eimprss: impress, premiss, simpers
flosw: flows, fowls, wolfs
'deksu: Duke's, duke's
acenrstu: Etruscan, centaurs
adeeinrstt: reinstated, straitened
adeeinrstu: unreadiest, unsteadier
gilnru: luring, ruling
deestw: stewed, tweeds
deestt: detest, tested
ahkrs: harks, shark
adeprst: departs, petards
cdeehipr: ciphered, decipher
nstu: nuts, stun, tuns
'gmpsyy: Pygmy's, pygmy's
derry: Ryder, dryer
'aimmoss: Maoism's, Mimosa's, mimosa's
'amst: ATM's, mat's, tam's
'amsx: Max's, max's
'amsy: Amy's, May's, may's, yam's
horsu: Horus, hours
horst: Short, short
'amrs: Mar's, RAM's, arm's, ram's
addeinr: dandier, drained
aostt: stoat, toast
cerstu: Custer, cruets, truces
eimpstu: impetus, imputes
'deerrsss: dresser's, redress's
ailmnopy: Olympian, palimony
ceehiknrt: Kitchener, thickener
eeenprrst: presenter, represent
'mprstu: Trump's, trump's
'aegnrs: anger's, range's
'adeimrrs: admirer's, married's
akprs: Parks, parks, spark
acdeeinorst: considerate, desecration
aimmoss: Maoisms, mimosas
'eersst: Ester's, ester's, reset's, steer's
'eerssv: serve's, verse's
'aderst: trade's, tread's
'adersw: Dewar's, wader's
'esst: EST's, Set's, set's
degilor: gloried, godlier
'abeilors: Alberio's, Albireo's
ddeenrs: Dresden, reddens
efgors: forges, gofers
deginnrssu: undersigns, undressing
'anst: Nat's, ant's, tan's
degilmn: melding, mingled
'anps: Pan's, nap's, pan's
eeimnss: Nemesis, Siemens, nemesis
degilnt: glinted, tingled
bdeorstu: doubters, obtrudes, redoubts
degilnu: dueling, eluding, indulge
'anns: Ann's, Nan's
adeeenrtv: enervated, venerated
'hnopsty: Python's, python's
dintuy: nudity, untidy
ahkns: ankhs, hanks, khans, shank
adimost: diatoms, mastoid
degilrs: girdles, gliders
aeeginnrt: Argentine, tangerine
abgiknr: barking, braking
cegiilnns: licensing, silencing
nrtu: runt, turn
'disss: SIDS's, diss's
hostu: South, shout, south, thous
'alps: lap's, pal's
'alsw: awl's, law's
'bckllosu: Bullock's, bullock's
nrsu: runs, urns
hosst: hosts, shots
'innoos: Onion's, onion's
eilnpsu: lineups, lupines
'innosu: Inonu's, Union's, union's
'aacinnorst: Carnation's, carnation's
ahirst: Ishtar, Trisha
eeiqrtu: quieter, requite
eeiqrsu: esquire, queries
'aegmns: Megan's, mange's
acdeeginrt: Centigrade, centigrade
aehippst: epitaphs, happiest
adgrs: drags, grads
dinstu: Dustin, nudist
eirsst: Sister, resist, sister
eefnortw: Freetown, forewent
eirstv: rivets, strive
eirstw: wriest, writes
gnorst: Strong, strong
eefrst: fester, freest
eilnoss: insoles, lesions, lioness
'eelrsv: lever's, revel's
'aaahnnssv: Savannah's, savannah's
ceilmops: compiles, complies, polemics
'amns: Man's, Nam's, man's
'acehlors: cholera's, chorale's
'amps: Pam's, amp's, map's
hortw: throw, worth, wroth
adeelrst: Lestrade, treadles
'ajnoss: Jason's, Sonja's
demnotu: demount, mounted
ahirs: Shari, hairs
acehinrru: hurricane, raunchier
eehlnopty: polythene, telephony
acilnort: cilantro, contrail
'addinors: Android's, android's
ddeellw: Weddell, dwelled
'abeeilnss: Balinese's, baseline's
defgiiins: dignifies, signified
'aeglns: Angel's, angel's, angle's
'afiilnorstt: filtration's, flirtation's
'aeglrs: glare's, lager's, large's
addei: Addie, aided
adder: adder, dared, dread
ahist: Thais, Tisha, saith
addel: addle, laded
aknst: stank, tanks
dehimnos: Sondheim, hedonism
aknsy: Yanks, snaky, yanks
'eelsst: sleet's, steel's
aknrs: narks, ranks
aehmrss: marshes, mashers
aehmrst: Amherst, hamster
emmrsu: Summer, summer
eirrsv: Rivers, rivers
aknor: Akron, Koran
'adeprs: drape's, padre's
eeimprs: empires, premise
hoost: hoots, shoot, sooth
'aprs: Apr's, par's, rap's
'apss: SAP's, asp's, sap's, spa's
'apst: ATP's, pat's, tap's
'apsy: pay's, yap's
adellott: allotted, totalled
acilnopt: Platonic, platonic
enstu: tunes, unset
hoops: hoops, poohs
cefors: forces, fresco
'eoprsstt: protest's, spotter's
'eoprsstu: Proteus's, posture's
adefr: Freda, fared
cejkoy: Jockey, jockey
adeem: Meade, Medea, edema
dghilmost: Goldsmith, goldsmith
'hllsu: Hull's, hull's
addelsw: dawdles, swaddle, waddles
'aeemprs: Ampere's, ampere's
addelrw: dawdler, drawled
npsu: puns, spun
acmstu: Muscat, muscat
adelp: paled, pedal, plead
adeln: Alden, Nelda, laden
adelm: lamed, medal
adell: Della, ladle
adely: Daley, delay
adelt: Delta, dealt, delta
adels: dales, deals, lades, leads
adelr: Adler, alder
acdinr: Cardin, rancid
adekn: knead, naked
adekr: Drake, drake, raked
'aaceghnors: Anchorage's, anchorage's
dehnorsu: enshroud, unhorsed
adens: Andes, Danes, Sedna, Snead, deans, sedan
adenr: Andre, Arden, Daren, Nader
adenu: Auden, Duane
adent: Dante, anted
ademn: Medan, admen, amend, named
ademr: armed, dream
ademt: mated, tamed
adems: Edams, dames
adeht: death, hated
adehr: hared, heard
adehs: Hades, ashed, heads, shade
adehy: hayed, heady
adegr: Edgar, grade, raged
adegm: Madge, gamed
adegp: gaped, paged
'aimors: Maori's, Mario's
adeis: Sadie, aides, aside, ideas
aorst: Astor, Sarto, roast, sorta, taros
adeil: Delia, ailed, ideal
adeim: Media, aimed, media
achnst: chants, snatch, stanch
enrst: Ernst, Stern, rents, stern, terns
enrsu: nurse, runes
adest: dates, sated, stead
adesw: Dawes, sawed, wades
'acdeiimnost: decimation's, medication's
adesv: Vedas, saved
adesz: adzes, dazes
defloor: flooder, floored
ehlorsst: holsters, hostlers
adeor: adore, oared
'nostw: town's, wont's
adepr: drape, padre, pared, raped
giinnns: innings, sinning
adept: adept, taped
iklnsy: Slinky, slinky
'agnrsty: Gantry's, gantry's
aceisstu: sauciest, suitcase
adert: rated, tared, trade, tread
aderv: Vader, raved
aderw: Dewar, wader
aders: dares, dears, reads
aacllsuy: casually, causally
imsty: Misty, misty
cdhors: chords, schrod
deeeloprsv: developers, redevelops
hkoos: hooks, shook
aenoprssttt: Protestants, protestants
notw: town, wont
noty: Tony, tony
aeegnrst: estrange, reagents, sergeant
aeegnrsv: avengers, engraves
degiint: dieting, editing, ignited
chikst: kitsch, shtick
'aors: Ora's, oar's
egnors: Negros, goners
achnor: Charon, anchor
achnos: Sancho, nachos
akmrs: Marks, marks
cersttu: curtest, cutters
'aost: Tao's, oat's
elrsstu: results, rustles
aadimnnr: Mandarin, mandarin
'irss: IRS's, sir's
'aamnosz: Amazon's, amazon's
adeehknr: hankered, harkened
bsuy: busy, buys
bstu: bust, buts, stub, tubs
eeerrsv: reserve, reveres, reverse, severer
bssu: buss, subs
adeilsttu: altitudes, latitudes
'airs: IRA's, Ira's, air's
addemns: demands, maddens
denst: dents, tends
'aimrs: Irma's, Mari's, Mira's, amir's
densu: dunes, nudes
denrs: nerds, rends
denru: nuder, under
'ainsstu: Austin's, Unitas's
aiopst: patios, patois
'eelmrs: Elmer's, Merle's
denps: pends, spend
denoz: dozen, zoned
denot: noted, toned
nosw: Snow, owns, snow, sown
nosy: Sony, nosy
denos: nodes, nosed
nosu: nous, onus
nost: snot, tons
denow: endow, owned
'ains: Ian's, Ina's
aioptu: Utopia, utopia
anoprss: Parsons, parsons
anoprst: patrons, tarpons
'aeilnsssst: saltiness's, stainless's
afgilno: foaling, loafing
'aims: Mai's, Mia's, aim's
aceilpr: caliper, replica
aklst: stalk, talks
eeiprrtt: preterit, prettier
aceilmr: miracle, reclaim
ahooy: Yahoo, yahoo
giorv: Virgo, vigor
aceilst: elastic, laciest
adeeprsv: depraves, pervades
adeeprst: pederast, predates
aceiltt: lattice, tactile
aceilrt: article, recital
'eors: ore's, roe's
abipsstt: Baptists, baptists
aeegnrsst: estranges, greatness, sergeants
aaelnprt: parental, paternal, prenatal
'chkssu: Kusch's, shuck's
gstuy: gusty, gutsy
defiilns: infidels, infields
'acfrst: Craft's, craft's
bceilmnou: Columbine, columbine
eeiprrss: reprises, respires
aaegmnrs: Semarang, managers
adeehlrt: haltered, lathered
'acginrsv: carving's, craving's
'ainst: Nita's, Tina's, anti's
'ainrs: Iran's, Nair's, rain's
eijnor: joiner, rejoin
'ahsy: Hay's, hay's
addentu: daunted, undated
deopr: Pedro, pored, roped
deops: dopes, posed
deopt: depot, opted
'ahms: Ham's, ham's
'ajnstu: jaunt's, junta's
chinop: Chopin, phonic
deosw: dowse, sowed
deost: Odets, dotes
adehoort: Dorothea, Theodora
deorv: Dover, drove, roved
egilnorw: lowering, roweling
abeeknnr: Banneker, Bernanke
deeinprsst: Presidents, presidents
adeinnoott: denotation, detonation
ginor: Ringo, groin
cgilnosw: cowlings, scowling
'aaegstwy: gateway's, getaway's
'abeillrs: Braille's, braille's, liberal's
ddeeims: demised, misdeed
'ensw: new's, wen's
'enst: net's, ten's
aeiilorsst: solitaires, solitaries
aiorsv: Savior, savior
densttu: student, stunted
ddeeirs: derides, desired, resided
'enos: Noe's, eon's, one's
cdeeoprru: procedure, reproduce
'bdemoors: bedroom's, boredom's
egiinprrs: reprising, respiring, springier
eegnnort: Roentgen, roentgen
beeioqssu: Essequibo, obsequies
ginsw: swing, wings
ginsu: Ginsu, suing, using
ijnorsu: Juniors, juniors
ginss: signs, sings
bginor: boring, robing
ginst: sting, tings
ginrs: grins, rings
noops: snoop, spoon
prsuu: Purus, usurp
'acehrstt: chatter's, ratchet's
adhry: Hardy, Hydra, hardy, hydra
gilnoos: loosing, soloing
adhor: Rhoda, hoard
gilnoop: looping, pooling
gilnoot: looting, tooling
eehorvw: however, whoever
adhny: Handy, Haydn, handy
'ehjopss: Joesph's, Joseph's
abgilmn: ambling, blaming, lambing
efinsst: fitness, infests
'aikss: Saki's, saki's
deeimprs: premised, simpered
abginu: Bangui, Ubangi
afginrt: farting, rafting
'eehlst: Ethel's, Lethe's
ahmss: shams, smash
acciorst: Socratic, acrostic
ahmrs: Marsh, harms, marsh
aeghnopt: heptagon, pathogen
ahmnu: Nahum, human
adeehilprs: dealership, leadership
deinoops: Poseidon, poisoned
'alos: AOL's, Lao's, Ola's
beeefir: beefier, freebie
klooostu: lookouts, outlooks
aeghnorv: hangover, overhang
aegilmnnt: alignment, lamenting
'ipst: pit's, tip's
deginor: Negroid, eroding, ignored, redoing
gimpy: Pigmy, gimpy, pigmy
deginnr: grinned, rending
deginnt: denting, tending
deginns: endings, sending
adeeimrst: diameters, dreamiest
denoops: snooped, spooned
ainoptu: Utopian, utopian
ainopss: Passion, passion
adegginnr: deranging, gardening
acdeinoorst: coordinates, decorations
'acenrsv: cavern's, craven's
'acenrst: Cretan's, canter's, nectar's, trance's
adisy: Daisy, daisy
adisv: Davis, divas
'ailns: Lina's, nail's
aacflrt: flatcar, fractal
'ailms: Lima's, mail's
acdegr: cadger, graced
'gnosw: Wong's, gown's
acdehs: cashed, chased
'ailsv: Vila's, vial's
gilnpsu: plugins, pulsing
adior: Dario, radio
ahmnnstu: huntsman, manhunts
'cchosst: Scotch's, scotch's
brsu: burs, rubs
aeeginnrtv: enervating, venerating
addgilnw: dawdling, waddling
brru: Burr, burr
'ailss: Lisa's, sail's
acdekr: arcked, racked
acdekl: calked, lacked
'ailrs: lair's, liar's, lira's, rail's
bruy: Ruby, bury, ruby
'orsttu: trout's, tutor's
adiry: dairy, diary
acdelr: Calder, cradle
acdels: decals, scaled
acdeln: candle, lanced
brtu: Brut, Burt
eeelptty: Teletype, teletype
acdemp: camped, decamp
acdenr: craned, dancer
adilv: Advil, Vidal, valid
adily: Lydia, daily
acdeno: canoed, deacon
acdent: canted, decant
acdens: ascend, dances
adims: Midas, maids
acdepr: carped, redcap
adinr: Darin, Indra, Randi, drain, nadir
adinv: Dvina, divan, viand
acderv: carved, craved
acders: cadres, cedars, sacred, scared
acdert: carted, crated, traced
dellorst: drollest, strolled
acdesu: caused, sauced
ahlsu: Shula, hauls, hulas
ahlst: halts, laths, shalt
adiil: Iliad, Lidia
ahlsw: Walsh, shawl
ahlno: Halon, halon
'elms: Mel's, elm's
ddeegin: deeding, deigned
'belorsst: bolster's, lobster's
ahlos: halos, shoal
ahlot: altho, loath
afgimnr: farming, framing
acddeeimt: decimated, medicated
aceerrst: caterers, retraces, terraces
acmors: Marcos, caroms, macros
agimnnn: Manning, manning
eflorsw: Flowers, flowers
ahlls: halls, shall
denoprs: ponders, respond
aaahnnsv: Savannah, savannah
emmrssu: Summers, summers
adeelprs: pleaders, relapsed
adeelpry: parleyed, replayed
adeeimstt: estimated, meditates
ainoort: Ontario, oration
'acdemorst: Democrat's, democrat's
adimnos: Madison, domains
'acensst: ascent's, stance's
esuz: Suez, Zeus
eegkrs: Greeks, Kresge
ceiprrstu: Scripture, scripture
aghilmty: Almighty, almighty
estu: Tues, suet
estz: Zest, zest
esty: stye, yest
estv: vest, vets
estw: West, stew, west, wets
cdegiinnrs: discerning, rescinding
'aaceinrss: Canaries's, cesarian's
esst: Tess, sets
ghis: Gish, sigh
essu: sues, uses
'aceprs: caper's, crape's, recap's
cceeirsv: cervices, crevices
ehrssu: rushes, ushers
'aacinorst: Croatian's, raincoat's
hlloy: Holly, holly
cddeesu: deduces, seduced
aegnrs: Sanger, angers, ranges
aegnrr: Garner, garner, ranger
eorrsst: resorts, rosters, sorters
aeprssst: sparsest, trespass
ekosst: Stokes, stokes
'eirssst: Sister's, resist's, sister's
'bhorst: broth's, throb's
adinors: inroads, ordains
aegnor: Genaro, Orange, orange
'ailosttty: Tolyatti's, totality's
'eerss: Erse's, seer's
opsu: opus, soup
opst: Post, opts, post, pots, spot, stop, tops
'efghirst: fighter's, freight's
cdeeiorrsv: discoverer, rediscover
ginoprstu: posturing, sprouting
eeprsu: peruse, purees, rupees
ajnos: Jason, Jonas, Sonja
eeprst: Peters, pester, peters, preset
ennpy: Penny, penny
cdors: cords, scrod
'ailmrsstu: altruism's, muralist's
'efillrs: filler's, refill's
ennot: tenon, tonne
'accefiiinorstt: certification's, rectification's
ghsu: gush, hugs
aacclru: accrual, caracul
ceginnnott: contenting, contingent
demprstu: Dumpster, dumpster
aellrsu: allures, laurels
ajntu: jaunt, junta
ghos: gosh, hogs
'nnossy: Sonny's, sonny's
'eelnors: Lenore's, Lorene's
aceeiipprtt: peripatetic, precipitate
aeeiprsstt: striptease, tapestries
ghnu: Hung, hung
aghilnss: hassling, slashing
aahkllmr: Hallmark, hallmark
abekrr: Barker, barker
abekrs: bakers, brakes, breaks
aabcehilmnr: Chamberlain, chamberlain
erty: Trey, Tyre
ersu: rues, ruse, sure, user
acdilnor: Alcindor, ironclad
cnoott: Cotton, cotton
ekorrw: rework, worker
ekorst: stoker, stroke
aennrt: Tanner, tanner
efginorst: foresting, fostering
'aekmrrs: Kramer's, marker's, remark's
'adosty: toady's, today's
ehlsstu: hustles, lushest, sleuths
'beors: Boer's, Ebro's, bore's, robe's
'ablopsyy: Playboy's, playboy's
bdeeffru: buffered, rebuffed
aegmnr: German, manger
aacimnor: Marciano, macaroni
enort: tenor, toner
enors: Norse, snore
eeilnrsst: listeners, reenlists
'cceknosy: Cockney's, cockney's
dgiilns: sidling, sliding
orst: rots, sort, tors
defmors: deforms, serfdom
orsu: ours, sour
ortu: rout, tour
ortt: tort, trot
enosy: Noyes, nosey
enost: Seton, Stone, notes, onset, stone, tones
'elrsstu: Ulster's, luster's, lustre's, result's, rustle's
orty: Tory, Troy, troy, tyro
adeerrst: arrested, retreads, serrated
eelprst: petrels, respelt
eelprsu: Slurpee, repulse
aeglrs: Glaser, glares, lagers, larges
enopr: Peron, prone
enops: Epson, opens, peons, pones
'adlnpsu: Dunlap's, upland's
ceeprsst: respects, scepters, specters
aeimnoprttu: importunate, permutation
eeirrst: retires, retries
cdeiinrstt: distincter, interdicts
dginorsw: drowsing, wordings
abehrt: Bertha, bather, breath
aeflnoopsstu: teaspoonfuls, teaspoonsful
'acenos: canoe's, ocean's
'amorsu: Mauro's, amour's
'amorsy: mayor's, moray's
ainprtu: Puritan, puritan
'acenrs: crane's, nacre's
affnors: Sarnoff, saffron
'eoprs: pore's, rope's
eegins: genies, seeing
'eopss: peso's, pose's
'airsst: sitar's, stair's
cceginnort: concerting, concreting
'beehops: Phoebe's, phoebe's
deloops: poodles, spooled
aaclrs: rascal, scalar
aegprs: grapes, pagers
aaclsu: casual, causal
ciiknpst: nitpicks, stickpin
adehlss: hassled, slashed
'deorsv: Dover's, drove's
kmno: Monk, monk
dehinosst: dishonest, hedonists
'aegginors: Georgian's, Georgina's
eloort: looter, retool
'acimoss: Mosaic's, mosaic's
'esstu: Tues's, suet's
'accirst: Arctic's, arctic's
adfhlnsu: handfuls, handsful
aehimsss: Messiahs, messiahs
eeirstt: Trieste, testier
'aiimnprsstu: Puritanism's, puritanism's
eeirstv: restive, veriest
cdinostu: conduits, discount
ailottty: Tolyatti, totality
aceilnost: coastline, sectional
aekottu: outtake, takeout
'ikns: ink's, kin's
dgimnoo: Domingo, dooming
'esstz: Zest's, zest's
'esstw: West's, stew's, west's
'inors: Orin's, iron's
'beilrsst: blister's, bristle's
'ikst: Kit's, kit's
abeirs: Serbia, braise, rabies
aeilnst: entails, salient, saltine
'pssu: pus's, sup's
aeilnrt: Latiner, latrine, reliant, retinal
eeirsvw: reviews, viewers
gill: Gill, gill
aeilnpr: plainer, praline
gikn: King, king
aeeortv: overate, overeat
aeilnot: elation, toenail
aeilnor: Loraine, aileron
oott: Otto, Toto, toot
ccorsu: crocus, occurs, succor
aegort: Ortega, Tagore, garote
oost: Soto, soot
'accenrs: Cancer's, cancer's
ddeggru: drugged, grudged
oort: Oort, Root, root
'bnossu: bo'suns, bonus's, bosun's
'aegnnopst: Pentagon's, pentagon's
egrsu: surge, urges
aorsst: assort, roasts
adeeginnrs: Grenadines, serenading
gipr: grip, prig
abbbgiln: babbling, blabbing
aceeeilmnpt: mantelpiece, mantlepiece
gins: gins, sign, sing
ginr: grin, ring
gint: Ting, ting
'acistt: Attic's, attic's
gisw: swig, wigs
cddeeer: decreed, receded
bkoors: Brooks, brooks
'inpss: snip's, spin's
aenprt: entrap, parent
girt: girt, grit, trig
girs: Gris, rigs
efirst: refits, rifest, sifter, strife
efirrs: Ferris, friers
ddegnu: dunged, nudged
'bells: Bell's, bell's
kory: Kory, York
'belos: bole's, lobe's
aadn: Adan, Dana
bdeeggrsu: begrudges, debuggers
aabs: Saab, baas
ddegru: Drudge, drudge
aabl: Alba, Baal
'belsu: blue's, lube's
'abmrsu: Burma's, rumba's
glos: logs, slog
aamr: Mara, Rama
acdeiiprt: patricide, pediatric
epprsu: supper, uppers
glpu: gulp, plug
'belmmrsu: Brummel's, mumbler's
abbcelrs: Scrabble, scrabble
bdelloor: bordello, doorbell
aeilmns: menials, seminal
aeilmnr: manlier, mineral
aeilmnn: lineman, melanin
aalv: Alva, lava
aaln: Alan, Lana, anal
aalm: Alma, lama
aalr: Alar, Aral, Lara
'aaijnstu: Juanita's, Tijuana's
'acceips: icecap's, ipecac's
aajr: ajar, raja
aaenpst: anapest, peasant
aagl: alga, gala
adeeginrr: grenadier, rereading
aagr: Agra, agar, raga
aeeilnorstv: Revelations, revelations
aeilmrs: mailers, realism
acddeenst: decadents, descanted
glno: Long, long
'abegmnosy: bogeyman's, moneybag's
'aadimnnrs: Mandarin's, mandarin's
aeilmss: Melissa, aimless
'eeginsss: Genesis's, genesis's
eeiilmprssvy: impressively, permissively
adehrst: dearths, hardest, hatreds, threads, trashed
emnnooost: monotones, moonstone
eeloprssty: polyesters, proselytes
'eorss: Eros's, Rose's, rose's, sore's
'eorsv: Rove's, over's
aars: Saar, Sara
glsu: lugs, slug
'imrs: MRI's, Mir's, rim's
agilnpsy: palsying, splaying
'imst: MIT's, Tim's
ginopr: poring, roping
ddegilr: girdled, griddle
aclrsw: crawls, scrawl
ahmnsu: Hamsun, humans
aeilnrst: entrails, latrines
aegirt: gaiter, triage
acghins: cashing, chasing
aegimn: enigma, gamine
acghinr: arching, chagrin
aegimr: Margie, gamier, mirage
aegims: ageism, images
'abeirstt: biretta's, terabit's
ddegir: girded, ridged
ddegil: gilded, glided
aegiln: genial, linage
'eimrst: merit's, miter's, timer's
aeginu: Guinea, guinea
aegins: Gaines, easing
aeginr: Regina, regain
abeu: Beau, beau
abet: abet, bate, beat, beta
aabhistt: Baathist, habitats
abek: bake, beak
aben: Bean, bane, bean
abel: Abel, Bela, Elba, able, bale
aber: Reba, bare, bear
'abfflosu: Buffalo's, buffalo's
aaceglostu: catalogues, coagulates
abgr: brag, garb, grab
abgs: bags, gabs
cefhnr: French, french
'aeggjnrstuu: Juggernaut's, juggernaut's
ehopprs: hoppers, shopper
aeilnpss: painless, spaniels
aeilnpst: panelist, plainest
abby: Abby, baby
ddefor: fodder, forded
belrstu: bluster, butlers, subtler
abcs: cabs, scab
behlssu: blushes, bushels
aceegils: elegiacs, legacies
cnostu: Tucson, Tuscon, counts
abdu: baud, daub
abdr: Brad, bard, brad, drab
abde: abed, bade, bead
'aaeiprsst: aspirate's, parasite's
abns: bans, nabs
abnr: Bran, barn, bran
cefhis: chiefs, fiches
cefhit: Fichte, fetich
abos: Boas, boas
aamnoz: Amazon, amazon
abeglm: Gamble, gamble
abegln: Bengal, bangle
abeglr: Grable, garble
abegls: bagels, gables
abil: Bali, bail
eegnrs: genres, greens
bcdeku: Dubcek, bucked
'bellosw: Bowell's, bellow's
'aenoprss: Pearson's, persona's
abkl: Kalb, balk
hlost: Holst, sloth
abls: albs, labs, slab
'accehns: Chance's, chance's
ablm: Lamb, balm, lamb
abll: Ball, ball
acinrsssu: Narcissus, narcissus
gilmnpu: lumping, pluming
'acessu: cause's, sauce's
egptu: Puget, getup
aenrst: astern, sterna
aenrss: Nasser, snares
cdlos: clods, colds, scold
cdlou: cloud, could
abry: Bray, bray
abrt: Bart, brat
abrs: bars, bras
accfiip: Pacific, pacific
eggmrsu: muggers, smugger
abtu: Batu, abut, tabu, tuba
aenrrt: Terran, errant, ranter
aenrrw: Warner, Warren, warren
aeghrt: Gareth, gather
abst: bast, bats, stab, tabs
abss: Bass, bass
aegimnst: mangiest, steaming
degiinnst: destining, indigents
afiilnortt: filtration, flirtation
egginrs: niggers, snigger
'acilopst: Capitol's, capitol's
abilopr: bipolar, parboil
'ilns: Lin's, nil's
'aceelrst: Electra's, treacle's
opsst: posts, spots, stops
'aahmrss: Marsha's, ashram's
opsty: Topsy, typos
acderssu: Crusades, crusades
opstu: pouts, spout
agiilnost: intaglios, isolating
degiinnnt: indenting, intending
abemnsu: Sunbeam, sunbeam
aceh: ache, each
aceg: Cage, cage
acer: acre, care, race
acep: Pace, cape, pace
acen: acne, cane
acem: Mace, acme, came, mace
acel: Alec, lace
aces: Case, aces, case
dfnou: fondu, found
acds: cads, scad
aclpss: clasps, scalps
aeglmn: legman, mangle
acin: Cain, Inca
aeglns: angels, angles, gleans
ehikrs: hikers, shriek, shrike
'dillsy: dilly's, idyll's
aeilnort: Oriental, oriental, relation
acjk: Jack, jack
ddeiov: devoid, voided
achp: Caph, chap
achr: arch, char
achs: Cash, cash
acmr: Marc, cram
gnow: Wong, gown
acms: cams, scam
acns: cans, scan
ackl: calk, lack
acks: cask, sack
aclm: calm, clam
aclo: coal, cola
acly: Clay, Lacy, clay, lacy
gnsu: Sung, gnus, guns, snug, sung
aehossttu: Southeast, southeast
acry: Cary, Cray, racy
acrs: arcs, cars, scar
acot: Cato, coat, taco
'bdeilrst: Dilbert's, driblet's
aeinprst: painters, pantries, pertains, repaints
acpt: Capt, pact
acpr: carp, crap
aensst: assent, sanest
'adeinnoostt: denotation's, detonation's
'efilrst: filter's, trifle's
aenstu: Austen, unseat
egouv: Vogue, vogue
egoru: rogue, rouge
actt: Catt, tact
egorr: Regor, Roger, roger
egors: gores, gorse, ogres
acst: Acts, acts, cast, cats, scat
acinostu: auctions, cautions
adehprs: Shepard, phrased, sharped
elostw: lowest, owlets, towels
acinosss: caissons, cassinos
aeimorstz: amortizes, atomizers
elosvw: vowels, wolves
'ainrst: Trina's, train's
'acerst: caret's, crate's, trace's
'acerss: Cesar's, scare's
aceinsstt: cattiness, scantiest, tacitness
'aadmrss: Madras's, madras's
ddeilr: Riddle, riddle
ostw: stow, tows, twos
ostt: tost, tots
ostu: oust, outs
osst: sots, toss
aachint: Ithacan, acanthi
delostu: loudest, tousled
adds: adds, dads
aeelprstt: saltpeter, saltpetre
adde: Edda, dead
oprst: ports, sport, strop
'aachimrss: archaism's, charisma's
adem: Edam, Mead, dame, made, mead
adel: Dale, Leda, dale, deal, lade, lead
aden: Aden, Dane, Dean, Dena, Edna, dean
adei: aide, idea
adeh: Head, head
adef: deaf, fade
adez: adze, daze
ader: Dare, dare, dear, read
aclors: Carlos, carols, corals
adev: Dave, Veda
adew: Wade, awed, wade
adgr: drag, grad
'abglnoos: Bologna's, bologna's
adhs: dash, shad
krtu: Kurt, Turk
adil: Dali, Dial, dial, laid
adim: amid, maid
adip: iPad, paid
adir: arid, raid
adis: aids, dais, said
adiv: avid, diva
adln: Land, land
adlo: Aldo, load
adlu: Laud, dual, laud
'ehnorst: Theron's, hornet's, throne's
'aeijmnss: Jasmine's, jasmine's
adms: dams, mads
ehrrsy: Sherry, sherry
adns: Sand, sand
adnw: Dawn, dawn, wand
adnr: Rand, darn
abeeln: baleen, enable
'ainsst: saint's, satin's, stain's
ador: Dora, road
aelrsstt: starlets, startles
'beirs: Brie's, bier's
eilppst: stipple, tipples
gmsu: gums, mugs, smug
eilpprs: ripples, slipper
adry: dray, yard
adrw: Ward, draw, ward
abeert: beater, berate, rebate
'beilmos: Mobile's, mobile's
'llmos: Moll's, moll's
'eostv: veto's, vote's
'ainstt: Titan's, taint's, titan's
'aderrst: retard's, trader's
eloruv: Louvre, louver, velour
'aderrsw: drawer's, reward's, warder's
egilnrst: Sterling, ringlets, sterling
adegmoprr: deprogram, programed
elorss: lessor, losers
elorsv: lovers, solver
elorsw: lowers, rowels, slower
ginnot: noting, toning
dgiinss: dissing, sidings
dgiinty: dignity, tidying
'inps: nip's, pin's
'aabhistt: Tabitha's, habitat's
aeft: fate, feat, feta
aefr: fare, fear
aefl: flea, leaf
'inst: isn't, nit's, tin's
aclopu: copula, cupola
egnor: Goren, Negro, goner
'bilssy: Sybil's, sibyl's
egilnnost: Singleton, singleton
abesst: basest, bastes, beasts
aemrsst: Masters, masters, streams
aemrssu: Erasmus, masseur
adnrtu: Durant, tundra
'allsw: Wall's, wall's
ejst: jest, jets
aeeglnr: enlarge, general
acgilnps: clasping, scalping
'eikms: Mike's, mike's
'horst: Roth's, Thor's
eersstt: setters, streets, tersest, testers
aceeeilmnpst: mantelpieces, mantlepieces
ghilopstt: spotlight, stoplight
'eikps: Pike's, pike's
ghlosu: ghouls, slough
'eikrs: Erik's, Keri's
ceeilns: license, silence
cikst: stick, ticks
'eikst: kite's, tike's
aeegilnnt: eglantine, inelegant
einooprs: poisoner, snoopier
aaceeirrstt: Secretariat, secretariat
aeennrss: ensnares, nearness
'ceinprs: Prince's, pincer's, prince's
aghilnt: halting, lathing
aalppy: PayPal, Paypal
'adgrs: drag's, grad's
ceoopr: Cooper, cooper
cikls: licks, slick
aett: Etta, Tate, teat
aesy: ayes, easy, yeas
'billsy: Billy's, billy's
egilnst: glisten, tingles
aesv: save, vase
aest: East, east, eats, sate, seat, teas
'cdeenprsu: Prudence's, prudence's
bdennrsuu: sunburned, unburdens
acddehr: Cheddar, cheddar
ceiklrst: stickler, trickles
rsstu: rusts, truss
acddein: Candide, candied
aepr: Earp, pare, pear, rape, reap
aeps: apes, apse, peas
aept: Pate, pate, peat, tape
egilnos: legions, lingoes
aerr: rare, rear
aers: Ares, ares, ears, eras, sear, sera
aert: rate, tare, tear
aerz: Ezra, raze
aerv: Reva, Vera, aver, rave
aerw: Ware, ware, wear
aery: aery, year
aelz: laze, zeal
aelx: Alex, axle
aels: Elsa, Lesa, ales, leas, sale, seal
aelr: Earl, Lear, earl, real
aelp: leap, pale, peal, plea
aelw: wale, weal
aelv: Elva, Vela, vale, veal
aelu: Eula, Laue
aelt: Leta, late, tale, teal
aeln: Lane, Lean, Lena, Neal, lane, lean
aelm: Elam, Elma, Male, lame, male, meal
aell: Ella, Lela
aekw: Wake, wake, weak
aekt: Kate, take, teak
aekl: kale, lake, leak
aenw: anew, wane, wean
aenv: Evan, Neva, nave, vane
aent: Etna, Nate, ante, neat
aens: Sean, sane
aenr: Erna, Rena, earn, near
aenp: Pena, nape, pane
'emprs: Perm's, perm's
aemr: Erma, mare, ream
aemt: mate, meat, tame, team
aems: Mesa, mesa, same, seam
aemn: amen, mane, mean, name
'hosst: host's, shot's
aeht: Thea, hate, heat
adqsu: quads, squad
adefilnot: deflation, defoliant
crstu: crust, curst
aehl: Hale, Leah, hale, heal
aehr: Hera, Rhea, hare, hear, rhea
aehs: Ashe, Shea
aegs: Sega, ages, sage
aegv: Vega, gave
eginoprs: reposing, spongier
'aelnps: Nepal's, panel's, plane's
aegg: Gage, gage
aeeglst: eaglets, legates
aegl: Gael, Gale, gale
aegp: Page, gape, page
aegr: gear, rage
aejn: Jane, Jean
aacdeglotu: catalogued, coagulated
agin: Agni, Gina, gain
agil: Gail, Gila
'eilns: Neil's, Nile's, lien's, line's
aacggilnotu: cataloguing, coagulating
'aelnos: Leona's, Oneal's
eirw: weir, wire
aemrrst: armrest, smarter
eirs: Eris, reis, rise, sire
aehrstt: hatters, shatter, threats
eirt: Teri, rite, tier, tire
'almss: alms's, slam's
'almsu: alum's, maul's
aehrssw: hawsers, washers
aehrsst: rashest, trashes
eipr: pier, ripe
aghs: gash, hags, shag
'eilms: Emil's, lime's, mile's
'eekls: keel's, leek's
eimn: mien, mine
eimt: emit, item, mite, time
eimr: Meir, emir, mire, rime
'aaimnrst: Martian's, Martina's
einv: vein, vine
einr: Erin, rein
eins: Ines, sine
eint: nite, tine
beinorw: Brownie, brownie
'eilsv: Levi's, evil's, veil's
eikm: Mike, mike
eikl: Kiel, like
eikr: Erik, Keri
eikp: Pike, pike
eikt: kite, tike
'almps: lamp's, palm's
ehilrt: Hitler, lither
eilm: Emil, lime, mile
eiln: Neil, Nile, lien, line
eilr: Riel, lire, rile
eils: isle, leis, lies
eilt: lite, tile
eilv: Levi, evil, live, veil, vile
'dehors: Herod's, horde's
amnoor: Romano, maroon
'eekps: keep's, peek's
cilry: Cyril, lyric
'ceinors: Corine's, Enrico's
'abciss: BASIC's, basic's
'aceelnsv: enclave's, valence's
'eekns: keen's, knee's
'aceelnrs: Carlene's, cleaner's
amnors: Romans, manors, ransom
'deossux: Exodus's, exodus's
agstuu: August, august
aceeilmsst: clematises, timescales
aghiknw: Hawking, hawking
aemrrtu: erratum, maturer
'aeilnost: elation's, toenail's
afst: fast, fats
'acinrssssu: Narcissus's, narcissus's
amnoss: Masons, Samson, masons
afrt: fart, frat, raft
egilmmn: Memling, lemming
'eelprssu: Slurpee's, repulse's
'aeilnors: Loraine's, aileron's
adrsw: draws, sward, wards
adrsy: drays, yards
'emops: mope's, poem's
'bilmos: Mobil's, limbo's
afos: oafs, sofa
afor: Afro, fora
'aelmss: Salem's, Selma's
'aelmsv: Melva's, Velma's
'acelmors: Carmelo's, Marcelo's
eirtttw: Twitter, twitter
crruy: Curry, curry
aflo: Olaf, foal, loaf
eivw: view, wive
'emost: Moet's, mote's, tome's
'emors: Rome's, more's
afit: Fiat, fiat
eist: site, ties
eisv: Ives, vies, vise
eisw: Wise, wise
abegiln: Algenib, Belgian, Bengali
'eimrs: emir's, mire's, rime's
'eiimnoprsss: impression's, permission's
'iprssu: Prius's, sirup's
'alnsu: Luna's, ulna's
'eimst: item's, mite's, time's
elru: lure, rule
elry: lyre, rely
elst: lest, lets
'alnos: Nola's, loan's
ahhs: hash, shah
'eimns: mien's, mine's
eluy: Yule, yule
elvy: Levy, levy
ahkn: Hank, Khan, ankh, hank, khan
ahlu: haul, hula
aginnpsw: spawning, wingspan
ahlt: halt, lath
aeegnrv: avenger, engrave
ahls: Hals, lash
ahll: Hall, hall
giinnru: inuring, ruining
'aceinnoorsstv: conservation's, conversation's
'adems: Edam's, dame's, mead's
aghinrs: garnish, sharing
ells: ells, sell
ellt: Tell, tell
aalrst: altars, astral
'adens: Aden's, Dane's, Dena's, Edna's, dean's
elly: Lyle, yell
elmo: Elmo, Lome, mole
aadeiprst: aspirated, disparate
'adesz: adze's, daze's
elno: Leno, Leon, Noel, Olen, lone, noel
elnt: Lent, lent
'aders: dare's, dear's, read's
elov: Love, love, vole
elop: Opel, Pole, lope, pole
elos: Leos, lose, sloe, sole
elor: lore, role
aabdlorr: Labrador, larboard
'adesv: Dave's, Veda's
elpt: lept, pelt
elpy: Pyle, yelp
eeilnppz: Zeppelin, zeppelin
'adehs: Head's, head's
agst: stag, tags
agsw: swag, wags
aeimnrsu: Sumerian, Suriname, aneurism
eiiinrstt: Trinities, trinities
eglorv: Glover, grovel
'adels: dale's, deal's, lead's
eefginr: freeing, reefing
acdeilst: citadels, dialects
deiostu: outside, tedious
aghinps: phasing, shaping
eglops: Gospel, gospel
'cersst: Crest's, crest's
'eegns: Gene's, gene's
ceefhist: chiefest, fetiches
'aehlmst: Thelma's, hamlet's
'cerstu: cruet's, truce's
eefgiln: feeling, fleeing
aacorsttu: actuators, autocrats
'adeis: aide's, idea's
adilorty: adroitly, dilatory, idolatry
agll: Gall, gall
aglo: Olga, goal
agls: gals, lags, slag
aclrsty: Crystal, crystal
eggilrw: wiggler, wriggle
acdeilms: decimals, declaims, medicals
agnw: Wang, gnaw
agnt: gnat, tang
agns: Sang, nags, sang, snag
'abddeiorss: broadside's, sideboard's
agny: Nagy, Yang
acensst: ascents, stances
'cdrsu: crud's, curd's
agps: gaps, gasp
'acdeeefnorst: Confederate's, confederate's
agot: goat, toga
abehimnos: Bohemians, bohemians
agoy: Goya, yoga
agry: Gary, Gray, gray
'emorss: Morse's, mores's
acdemort: Democrat, democrat
aahmrs: Marsha, ashram
aabdeginr: bargained, gabardine
'abckls: Black's, black's
'alors: Lora's, oral's
'deinnst: dentin's, indent's
'alosv: Olav's, oval's
ceeenrrt: Terrence, recenter
'aelprs: Pearl's, pearl's
aeilnsst: salients, saltines
cinos: coins, icons, scion, sonic
aimn: Mani, main
aimm: imam, maim
aims: Siam, aims
aimr: Irma, Mari, Mira, amir
ainv: Ivan, vain
'einst: nite's, tine's
'einsv: vein's, vine's
allmory: Mallory, morally
aberst: barest, breast
aberss: sabers, sabres
'aelpss: lapse's, sepal's
'aelpst: Patel's, petal's, plate's, pleat's
ainr: Iran, Nair, rain
aint: Nita, Tina, anti
ehinrs: shiner, shrine
aiks: Saki, saki
eggilns: leggins, negligs, niggles
'aelpps: Apple's, apple's
eksy: Skye, keys
aahnns: Anshan, Shanna
ailt: alit, tail
ailv: Vila, vial
acenrsv: caverns, cravens
acenrst: canters, recants, scanter, trances
deghilst: delights, slighted
'hoops: Pooh's, hoop's, pooh's
ails: Lisa, ails, sail
ailr: lair, liar, lira, rail
'ceijsstu: Justice's, justice's
ailm: Lima, Mali, mail
ailn: Lina, lain, nail
beikrsst: briskest, briskets
aacetv: caveat, vacate
'abinoss: Bosnia's, bonsai's
agginp: gaping, paging
'aclopsu: copula's, cupola's
'ehlost: helot's, hotel's
'efmorrs: former's, reform's
'alops: Alpo's, Opal's, opal's
'dehrss: sherd's, shred's
'aceimrs: Crimea's, Marcie's
orsttu: trouts, tutors
'ahlssw: Walsh's, shawl's
cdeir: cider, cried, riced
cdeit: cited, edict
'alnost: Alton's, talon's
agiilnrv: rivaling, virginal
agiilnrt: trailing, trialing
aaceeinnrss: Renaissance, renaissance
aehirssttw: swarthiest, sweatshirt
eeenrrstw: Westerner, westerner
aghimns: mashing, shaming
ceenrss: censers, screens
ahpt: Ptah, path
cdeor: cored, credo, decor
cdeos: codes, coeds
abdehorr: abhorred, harbored
ahns: Hans, Nash
adnors: Sondra, adorns
ahms: hams, mash, sham
cderu: crude, cured
aahnsu: Nashua, Shauna
ahtw: thaw, what
'deinnos: Dionne's, Donnie's
ahsy: Hays, ashy, hays
ahst: hats, shat
ahsw: Shaw, Wash, haws, wash
ahrt: Hart, Thar, hart
'dinsstu: Dustin's, nudist's
'accdeilnost: Occidental's, occidental's
'alpss: Alps's, slap's
'affnorss: Sarnoff's, saffron's
enrt: rent, tern
enrw: Wren, wren
deiopst: deposit, dopiest, posited, topside
ceiklnrs: clinkers, crinkles
entw: newt, went
gnorw: grown, wrong
cegoors: Scrooge, scrooge
ensw: news, sewn, wens
enst: nest, nets, sent, tens
enno: neon, none
ceeiprs: pierces, precise, recipes
eeilnrst: listener, reenlist, silenter
aeimnors: Romanies, moraines
enoz: Zeno, zone
enos: Enos, eons, noes, nose, ones
enor: Nero, Reno
cddeinostu: deductions, discounted
enot: Eton, note, tone
enop: nope, open, peon, pone
benoors: Osborne, Robeson
chklosy: Shylock, shlocky
adlny: Dylan, Lynda
eghilrst: lighters, slighter
'hillooprsw: Whirlpool's, whirlpool's
'aelssv: salve's, slave's
'aelsst: Stael's, least's, slate's, steal's
'ennost: tenon's, tonne's
gnouy: Young, young
'acersst: caster's, recast's
eprrsuu: pursuer, usurper
acegilnpr: parceling, replacing
aisv: Avis, Siva, Visa, visa
abenry: Barney, nearby
eiimnoprsss: impressions, permissions
allost: allots, atolls
allosw: allows, sallow
acghinnst: snatching, stanching
admno: Damon, nomad
aeefmnors: Freemason, forenames
airy: Iyar, airy
airs: airs, sari
doors: doors, odors, roods
'aghnos: Hogan's, hogan's
aegrtt: Target, target
bdelloors: bordellos, doorbells
doosw: Woods, woods
eeggir: Geiger, Reggie
aciimmnorst: Romanticism, romanticism
aegrrt: garret, garter, grater
deeforst: deforest, forested, fostered
aegrsz: gazers, grazes
'eoprst: Perot's, trope's
'eoprss: poser's, prose's, spore's
aegrsv: Graves, graves
aegrsu: argues, augers
aegrst: grates, greats
'eehnnorrrst: Northerner's, northerner's
abeillrs: Brailles, ballsier, liberals
abeillry: blearily, reliably
acegilnns: cleanings, cleansing
ceiostx: coexist, exotics
cehiistt: itchiest, theistic
ehinrss: shiners, shrines
'abcels: Caleb's, cable's
empr: Perm, perm
emop: mope, poem
emor: More, Rome, more
emot: Moet, mote, tome
emno: Nome, omen
nnosy: Sonny, sonny
'abcehs: Beach's, beach's
aagnors: Angoras, angoras
ceortv: covert, vector
bdelott: blotted, bottled
'aehosssttu: Southeast's, southeast's
bdelosu: bloused, doubles
egiilsttz: Stieglitz, glitziest
ceorsw: cowers, escrow
ceorsu: Crusoe, course, source
ceorst: Cortes, corset, escort, sector
akpr: Park, park
akos: oaks, soak
akor: Karo, okra
'acerrst: Carter's, Crater's, crater's, tracer's
'abilmsu: Malibu's, labium's
akns: Kans, sank
aknr: nark, rank
'aelrsy: Leary's, layer's, relay's
aknt: Kant, tank
akny: Yank, yank
akmr: Mark, mark
akln: Klan, lank
aklr: Karl, lark
emsu: Muse, emus, muse
addinrww: Windward, windward
'dorswy: dowry's, rowdy's
acdeimno: comedian, demoniac
adnor: Drano, NORAD, Ronda, adorn, radon
aahinst: Ashanti, Tanisha
eiopss: poises, posies
cdeiirstu: crudities, diuretics
'ceinsst: incest's, insect's
bdeloru: Boulder, boulder
hiirst: Irtish, Tishri
aehnnopt: Pantheon, pantheon
deiorrw: rowdier, wordier, worried
addehs: dashed, shaded
'eopssy: Sepoy's, poesy's
doprs: drops, prods
einprrt: printer, reprint
deiorsw: dowries, rowdies, weirdos
deiorst: editors, sortied, steroid, storied
aadeipprs: appraised, disappear
'emssu: Muse's, muse's
'aegimrst: Maigret's, ragtime's
epru: Peru, pure
eprs: Pres, reps
'ehllss: Shell's, shell's
epry: prey, pyre
epst: Sept, pest, pets, step
epsw: pews, spew
amntuu: Autumn, autumn
epsy: espy, yeps
eiilnoss: elisions, oiliness
'eelps: Peel's, Pele's, peel's
ehistw: Whites, whites
'aehlrst: halter's, lather's
ehistt: theist, tithes
'acipss: Spica's, aspic's
eelrsstt: settlers, trestles
allw: Wall, wall
eelrsstw: swelters, wrestles
ehisst: heists, thesis
'eelrs: leer's, reel's
alnu: Luna, ulna
alno: Nola, loan
almu: alum, maul
alms: alms, lams, slam
almp: lamp, palm
'beirst: Tiber's, tribe's
alps: Alps, laps, pals, slap
alov: Olav, oval
acenors: coarsen, corneas
alos: Laos, also
alor: Lora, oral
alop: Alpo, Opal, opal
aeeirstt: iterates, teariest, treaties, treatise
aeeirstw: sweatier, weariest
aacdensv: advances, canvased
alru: Raul, Ural
adnry: Randy, randy
'celrstuy: cruelty's, cutlery's
adnsy: Sandy, sandy
adnsw: dawns, wands
aeegillrs: allergies, galleries
alsy: lays, slay
'besst: Best's, best's
alsw: awls, laws, slaw
alst: last, lats, salt, slat
akss: Saks, asks
agikmns: makings, masking
abelry: barely, barley, bleary
abelst: ablest, bleats, stable, tables
abelsy: basely, belays
abelms: ambles, blames
ceoprss: corpses, process
abelmr: blamer, marble, ramble
'bbinors: Robbin's, ribbon's
einpsst: insteps, spinets
eiostv: Soviet, soviet
'adils: Dial's, dial's
adeoprrt: parroted, predator, prorated, teardrop
abelnu: nebula, unable
adeinostt: antidotes, stationed
'eirsw: weir's, wire's
'eirst: Teri's, rite's, tier's, tire's
'eirss: Eris's, rise's, sire's
ceginotv: Vietcong, coveting
ceefprst: perfects, prefects
'aosstt: stoat's, toast's
abeltt: Battle, battle, tablet
'ccmooors: Morocco's, morocco's
aeeinntv: Aventine, Venetian
'adiss: AIDS's, dais's
'aeelss: easel's, lease's
eorw: Rowe, wore
eorv: Rove, over, rove
eort: rote, tore
eors: Eros, Rose, ores, roes, rose, sore
ehlrsstu: hustlers, ruthless
ceopss: Scopes, copses, scopes
ehirtw: whiter, wither, writhe
eopp: Pope, pope
eops: peso, pose
eopr: pore, rope
'alsst: SALT's, last's, salt's, slat's
'dmoos: Odom's, doom's, mood's
abbciill: Biblical, biblical
dorsw: sword, words
bbnooru: Bourbon, bourbon
amno: Mona, Oman, moan
amny: many, myna
'eemst: meet's, mete's
ffgiinr: Griffin, griffin, riffing
eotv: veto, vote
ehirsv: shiver, shrive
'dehlors: Holder's, holder's
'gimpsy: Pigmy's, pigmy's
'aceehrrss: research's, searcher's
eosw: owes, woes
amry: Mary, Myra, army
amrs: Mars, arms, mars, rams
amrt: mart, tram
'ennpsy: Penny's, penny's
accilno: conical, laconic
amps: Spam, amps, maps
ampr: pram, ramp
amoy: Mayo, mayo
amot: atom, moat
amor: Omar, roam
agiknnr: narking, ranking
aellorv: allover, overall
aegnnopt: Pentagon, pentagon
'cenoorrs: coroner's, crooner's
amtt: Matt, matt
adoty: toady, today
'berst: Bert's, Bret's
amsy: Mays, yams
amsw: maws, swam
amss: Mass, mass
amst: mast, mats, tams
abcegimnr: cambering, embracing
aeilrrt: retrial, trailer
aeilrst: realist, retails, saltier
aacilr: Alaric, racial
aeilrss: Israels, airless, serials
aeilrty: irately, reality
addelnou: duodenal, unloaded
aacinr: Carina, crania
'aaimnors: Mariano's, Romania's
'cefiilsty: Felicity's, felicity's
bemoss: besoms, emboss
eiorst: Tories, sortie
bemors: somber, sombre
agiknst: skating, staking, takings, tasking
'eissw: Wise's, wise's
accefiiinorstt: certifications, rectifications
oprsstu: sprouts, stupors
eiimnoprss: impression, permission
dorwy: dowry, rowdy, wordy
'addinrsww: Windward's, windward's
'aagmms: gamma's, magma's
aegsst: sagest, stages
alprty: paltry, partly
'ahprss: Sharp's, sharp's
'adhss: dash's, shad's
ehlorst: holster, hostler
ehirstw: withers, writhes
aeeilnpst: Palestine, penalties
aekqsu: quakes, squeak
ehirssw: swisher, wishers
ehirssv: shivers, shrives
aeinrsstt: resistant, straitens
adeiiintt: dietitian, initiated
efhiorstt: fortieths, frothiest
achiint: Chaitin, Chianti
'abeerst: beater's, rebate's
'ackls: calk's, lack's
'ackss: cask's, sack's
deeghin: heeding, neighed
aelns: lanes, leans
aelnr: learn, renal
aelno: Leona, Oneal, alone
aelnp: Nepal, panel, penal, plane
aelnv: navel, venal
egiilnrsv: silvering, slivering
aelpp: Apple, apple
aelps: lapse, leaps, pales, peals, pleas, sepal
aelpr: Pearl, paler, pearl
aelpt: Patel, leapt, petal, plate, pleat
aahhopr: Pharaoh, pharaoh
aesttu: astute, statue
'aclms: calm's, clam's
'ahpst: Ptah's, path's
aegopst: Gestapo, postage
aelmp: ample, maple
aelms: Salem, Selma, lames, males, meals
aelmr: lamer, realm
aelmv: Melva, Velma
'enosstx: Sexton's, sexton's
bbboy: Bobby, bobby
ceersu: rescue, secure
ceerst: erects, secret
aelsw: Wales, wales, weals
aelss: sales, seals
aelst: Stael, Tesla, least, slate, stale, steal, tales, teals
aelsv: salve, slave, vales
aelrx: laxer, relax
aelry: Leary, early, layer, relay
hnopty: Python, python
aelrv: Ravel, ravel
aelrt: alert, alter, later
aelrs: earls, laser, reals
'gikns: King's, king's
aors: Rosa, oars, soar
'cdnoors: condor's, cordon's
aeltx: exalt, latex
ansty: nasty, tansy
anstu: aunts, tunas
'cdlos: clod's, cold's
ceegnorv: Congreve, converge
'aenprsst: Napster's, pastern's
'aacclrsu: accrual's, caracul's
'aehimsss: Messiah's, messiah's
ehiknrst: rethinks, thinkers
'aclos: coal's, cola's
'iklns: kiln's, link's
'iklos: Loki's, kilo's
'aclsy: Lacy's, clay's
ddeemrru: demurred, murdered
ijmmy: Jimmy, jimmy
cdeeeoprrss: predecessor, reprocessed
einorst: orients, stonier
cimmnnoosu: Communions, communions
anst: Stan, ants, tans
answ: sawn, swan
antu: aunt, tuna
aekns: Snake, snake, sneak
aekmr: Merak, maker
aekls: lakes, leaks, slake
anrt: Tran, rant
anry: Ryan, nary, yarn
'aabmnst: Batman's, bantam's
'aehrss: share's, shear's
'aehrst: Earth's, earth's, hater's, heart's
'ailorssty: royalist's, solitary's
ehinors: heroins, inshore
ehinopx: Phoenix, phoenix
irstw: wrist, writs
anov: Avon, Nova, nova
anor: Arno, Aron, Nora, Oran, roan
aekst: Keats, skate, stake, steak, takes, teaks
aeksw: Wesak, askew, wakes
anps: naps, pans, snap, span
cekrtu: Tucker, tucker
aekps: peaks, spake, speak
'cimmnnoosu: Communion's, communion's
anno: Nona, anon
ceikrst: rickets, sticker, tickers
aeeilnntv: Valentine, valentine
anoprs: aprons, parson
ceeilnrs: reclines, silencer
anoprt: patron, tarpon
aeeegnrst: generates, teenagers
ceeilnss: licenses, silences
hnorst: Norths, thorns
ceinoprssu: percussion, supersonic
'acdefiiinost: deification's, edification's
eilmntuy: minutely, untimely
dehilss: Shields, shields
'aerssttw: Stewart's, swatter's
'acins: Cain's, Inca's
ddegnoru: grounded, underdog
'loss: Sol's, sol's
'ioqstu: Quito's, quoit's
'lost: Lot's, lot's
'losw: low's, owl's
aeiinnstu: annuities, insinuate
'aeimnrs: Marine's, marine's
aeeenrtv: enervate, venerate
aeirrtty: Tertiary, tertiary
aenot: Eaton, atone, oaten
aeggilnr: ganglier, regaling
ciprss: crisps, scrips
adirsu: Darius, radius
aaeiprsst: aspirates, parasites
aegorvy: Voyager, voyager
ffhu: Huff, huff
aeeenrstv: enervates, venerates
inopt: pinto, piton, point
deegirv: diverge, grieved
aenps: Aspen, aspen, napes, panes
aensw: wanes, weans
aensv: Evans, naves, vanes
inors: irons, rosin
eisstx: exists, sexist
aeipsst: pasties, patsies
aenry: Reyna, yearn
eisstu: suites, tissue
aenrv: Verna, raven
aenrs: earns, nears, saner, snare
'dginos: dingo's, doing's
'deeinrssst: dissenter's, tiredness's
'ceeprs: creep's, crepe's
'ahrst: Thar's, hart's
bcistu: cubist, cubits
ceeptx: except, expect
'efgors: forge's, gofer's
'aeelsst: Estela's, teasel's
ceeprs: creeps, crepes
'aeelstz: teazel's, teazle's
ceginrsu: rescuing, securing
adelpps: dapples, slapped
aegorst: garotes, storage
erstw: strew, wrest
abglnoo: Bologna, bologna
ersst: rests, tress
erssu: ruses, users
beimrst: timbers, timbres
aceelnsv: enclaves, valences
aceelnru: Laurence, cerulean
aceelnrs: cleaners, cleanser
'ddegos: Dodge's, dodge's
aekrst: skater, streak, takers
'ceellnos: Colleen's, colleen's
ceenrs: censer, screen
ceenrt: center, recent
'achirsty: Charity's, charity's
'deiopsst: deposit's, topside's
aeiprss: aspires, praises, spireas
aeiprst: parties, pastier, pirates, traipse
aeiprsu: Piraeus, upraise
aeiprrs: parries, rapiers, raspier, repairs
ceegnorsss: Congresses, congresses
'aadilns: Dalian's, Danial's
ceiprrsstu: Scriptures, scriptures
acnoors: coronas, racoons
fglo: flog, golf
aemns: Mensa, manes, manse, means, names
aemnt: Manet, meant
'egnors: Goren's, Negro's, goner's
aeeenrrst: Easterner, easterner
adderw: Edward, warded
adders: adders, dreads, sadder
addert: darted, traded
aemst: mates, meats, steam, tames, teams
aemss: mesas, sames, seams
aemsx: exams, maxes
deiinoopst: deposition, positioned
aemrs: mares, reams, smear
inptu: Putin, input
inpss: snips, spins
apss: asps, pass, saps, spas
addenr: dander, darned
addens: sadden, sanded
apsy: pays, spay, yaps
apsw: Wasp, paws, swap, wasp
apst: past, pats, spat, taps
addemn: Madden, damned, demand, madden
'ahssw: Shaw's, wash's
errty: Terry, retry, terry
aciillnoost: colonialist, oscillation
'ahstw: thaw's, what's
dinosww: Windows, windows
aceenny: Cayenne, cayenne
aprs: pars, raps, rasp, spar
aprt: part, rapt, tarp, trap
aeksst: skates, stakes, steaks
aprw: warp, wrap
aceenss: Senecas, encases
aceirsst: Castries, scariest
addeil: dialed, laddie
addelw: dawdle, waddle
addels: addles, saddle
addelr: ladder, larded
addeln: dandle, landed
eimnoprstu: importunes, resumption
ceefiimnoprst: imperfections, perfectionism
'aeelrss: resale's, sealer's
aekmrr: Kramer, marker, remark
eefiirst: feistier, fieriest
cekoors: Crookes, cookers
'aeilnsst: salient's, saltine's
cehilno: Helicon, Nichole
deiinost: editions, sedition
accehimst: catechism, schematic
'clost: Colt's, clot's, colt's
accehimns: mechanics, mischance
abceilnpru: Republican, republican
'acnnnos: Cannon's, cannon's
'oprsst: sport's, strop's
aehsv: haves, shave
aehst: haste, hates, heats
aehsy: Hayes, yeahs
ellostu: outsell, sellout
aceelrt: Electra, treacle
aehrs: hares, hears, rheas, share, shear
aehrt: Earth, Harte, earth, hater, heart
astv: vast, vats
bbbdelo: blobbed, bobbled
aehny: Haney, hyena
aehnt: Ethan, neath
aehns: Shane, ashen
dehirsv: dervish, shrived
dehirst: dithers, shirted
'inopst: pinto's, piton's, point's
'afnnsy: Fanny's, fanny's
aehps: heaps, phase, shape
dggiiln: gilding, gliding
aiilmnosttu: mutilations, stimulation
aswy: sway, ways, yaws
aehks: hakes, shake
aehlz: Hazel, hazel
aehls: Sahel, hales, heals, leash, shale
aehlw: whale, wheal
aehlv: Havel, halve
abipstt: Baptist, baptist
aehlt: Letha, lathe
'aegorst: Ortega's, garote's
chmnu: Munch, munch
'acillosst: Callisto's, Castillo's
agghinns: gnashing, hangings
aehht: Heath, heath
dggiinr: girding, ridging
aiorsuv: saviour, various
adeemnnr: Menander, mannered
belrsu: Elbrus, rubles
adeemnor: demeanor, enamored
belrtu: Butler, butler
'abdnrsy: Brandy's, brandy's
'acprs: carp's, crap's
aeklnr: lanker, rankle
aeipprs: apprise, sappier
'bddsuy: Buddy's, buddy's
'desw: Wed's, dew's
fist: fist, fits, sift
'ders: Red's, red's
adinor: Dorian, inroad, ordain
'enops: open's, peon's, pone's
'emoorrs: Romero's, roomer's
aeklrw: Walker, walker
eorrst: Torres, resort, roster, sorter
adinrw: Darwin, inward
adinrs: drains, nadirs
adinsv: divans, viands
'aaillmns: Alnilam's, Manilla's
aceelprs: percales, replaces
bglos: blogs, globs
eiorrsst: resistor, roisters, sorriest
aegst: Gates, gates, stage
aegss: gases, sages
aegrz: gazer, graze
aegrt: Greta, grate, great
aegrs: gears, rages, sager
aegru: argue, auger
lmpsu: lumps, plums, slump
'deos: doe's, ode's
'dens: Ned's, den's, end's
aegpr: grape, pager
aegps: gapes, pages
arty: arty, tray
aceelpr: percale, replace
aegnr: anger, range
aegno: Genoa, Onega
arst: arts, rats, star, tars, tsar
'epsstu: setup's, upset's
chlru: churl, lurch
aceelnv: enclave, valence
aegln: Angel, Galen, angel, angle, glean
aceelns: cleanse, scalene
aceelnr: Carlene, cleaner
'ginss: sign's, sing's
aeglr: Alger, Elgar, glare, lager, large, regal
hinpsx: Sphinx, sphinx
aegmn: Megan, mange
'ginrs: grin's, ring's
aegmr: Marge, gamer
arwy: awry, wary
aadenn: Andean, Deanna
'defs: Fed's, fed's
aceinnsst: incessant, instances
'aabddlnss: Badlands's, badlands's
innou: Inonu, Union, union
innoo: Onion, onion
'abcnos: Bacon's, bacon's
aeelnsv: enslave, leavens
aeelnrr: learner, relearn
aaadilmnst: Dalmatians, dalmatians
chlny: Lynch, lynch
deorstu: detours, dourest
filt: flit, lift
'enost: note's, tone's
'enosz: Zeno's, zone's
eorsty: Troyes, oyster, storey, tyroes
eorstt: otters, tortes
eorstv: strove, voters
eorstu: ouster, routes
eorssu: rouses, serous
eorsst: sorest, stores
adimno: Damion, domain
'acehmrrs: charmer's, marcher's
'aabdlorrs: Labrador's, larboard's
'abelorst: Alberto's, Latrobe's
'bdelloors: bordello's, doorbell's
abeehilmnsstt: Establishment, establishment
eeinrsw: newsier, wieners
eeinrst: Steiner, entries
adimwy: Midway, midway
aaeilmnprst: parliaments, paternalism
eghopr: Gopher, gopher
eeinrtu: retinue, reunite, uterine
abdeinrs: Brandeis, brandies
ceerssu: rescues, secures
adimst: admits, amidst
acginr: arcing, caring, racing
bkrsu: Burks, brusk
aaddms: Addams, Saddam
'abchnrs: Branch's, branch's
adgginr: grading, niggard
'acnnos: Canon's, Conan's, canon's
'acehimrs: Chimera's, chimera's
ghnostu: gunshot, noughts, shotgun
'acprss: craps's, scrap's
aalmnu: alumna, manual
deeginrs: designer, redesign, resigned
cdeiorrst: creditors, directors
'bbelrsu: lubber's, rubble's
'eeerrssv: reserve's, reverse's
ddeefnru: refunded, underfed
aefmrrs: farmers, framers
cehiknt: kitchen, thicken
eeiimprssv: impressive, permissive
aeknss: snakes, sneaks
'iknss: sink's, skin's
inoopss: Poisson, poisons
inoopst: options, potions
'ehinopsx: Phoenix's, phoenix's
'abeerstt: Beretta's, abetter's
attw: Watt, watt
'aeeeprrst: repartee's, repeater's
dersstu: dusters, trussed
'iknos: ikon's, oink's
'dgilloosw: Goodwill's, goodwill's
'acnnost: Canton's, canton's
aaadmnr: Narmada, Ramadan
'dgos: God's, dog's, god's
abfflou: Buffalo, buffalo
ceerrsu: rescuer, securer
'chins: chin's, inch's
ennorsu: neurons, nonuser
eeinqru: Enrique, enquire
aeinv: Evian, Nivea, naive
aeinn: Annie, inane
aeilv: Elvia, alive
aeils: Elias, Elisa, aisle
aeiln: Aline, alien, aline
aeill: Allie, Leila, Lelia
'chist: chit's, itch's
'chirs: Rich's, rich's
aeirs: Aries, arise, raise
aeirt: Artie, irate
eiilmss: missile, similes
eiilmst: elitism, limiest
'einprrst: printer's, reprint's
ceenorsv: conserve, converse
ceghinort: Creighton, hectoring
'ahopsst: pathos's, potash's
bbeil: Bible, bible
aeelssstt: stateless, tasteless
belstu: bluest, bustle, sublet, subtle
'acost: coat's, taco's
abehimno: Bohemian, bohemian
aeijm: Jaime, Jamie, Mejia
aeelpss: elapses, pleases
aeelprs: relapse, repeals
chnpu: Punch, punch
aeilrrst: retrials, trailers
achirty: Charity, charity
emrstu: Sumter, muster
eipqu: equip, pique
adeemrst: mastered, streamed
'hmos: HMO's, ohm's
eipps: Pepsi, pipes
deggru: grudge, rugged
adeiinoprtt: partitioned, trepidation
bdeinrs: binders, rebinds
aadeginr: drainage, gardenia
eipsw: swipe, wipes
aceghinrtt: chattering, ratcheting
eiprs: piers, pries, spire
cdekor: corked, rocked
eglos: loges, ogles
deeimnorsz: modernizes, sermonized
'aceorrst: Creator's, creator's, reactor's
'cegnorsss: Congress's, congress's
eegrst: egrets, greets
deggir: digger, rigged
aeorstt: Rosetta, rotates, toaster
aginrsty: stingray, straying
'brstu: Brut's, Burt's
eglru: Luger, gruel
aemorrsy: Rosemary, rosemary
'enrst: rent's, tern's
'aepsst: paste's, spate's
'brsuy: Ruby's, ruby's
flow: Wolf, flow, fowl, wolf
aacflrst: flatcars, fractals
'ahhss: hash's, shah's
'aersswy: Sawyer's, sawyer's
'aorss: Rosa's, soar's
'dfors: Ford's, ford's
ceeinv: Venice, evince
dgginnu: dunging, nudging
'hiirsst: Irtish's, Tishri's
ceeipr: Pierce, pierce, recipe
ceeips: pieces, specie
eeiinnst: Einstein, nineties
aaginssy: assaying, gainsays
eikrst: strike, trikes
eikrss: kisser, skiers
ceiklnr: clinker, crinkle
'aersstw: Waters's, waster's, waters's
'eemrsy: Emery's, Meyer's, emery's
adeeilnt: dateline, entailed
eiorsst: rosiest, sorties, stories
aensttu: attunes, tetanus
'adefirs: Freida's, Frieda's
achisty: Chasity, Scythia
'girst: girt's, grit's, trig's
giimnr: miring, riming
deiinsst: insisted, tidiness
eiknrtt: knitter, trinket
eiqtu: quiet, quite
'aelprsy: parley's, player's, replay's
efinst: feints, finest, infest
eeginpsw: sweeping, weepings
dggilno: Golding, lodging
aelprsst: Psalters, plasters, staplers
aegilnpry: parleying, replaying
aelprstt: platters, prattles, splatter
aaccinrtt: Antarctic, antarctic
'hknsu: Kuhn's, hunk's
aenoprs: Pearson, persona
aeehirstt: earthiest, heartiest
beenstu: Steuben, subteen
deeilnst: enlisted, listened, tinseled
'diss: Dis's, Sid's, dis's
eeenorsv: Veronese, overseen
'aginpprsst: strapping's, trappings's
aaginrrs: Srinagar, arraigns
moprs: proms, romps
deiorstw: rowdiest, wordiest
ceehps: cheeps, speech
cdeorsu: coursed, scoured, sourced
emnort: Merton, mentor
emnoor: Monroe, Moreno
fmor: form, from
ceehrs: Escher, cheers
cekorst: restock, rockets
abefllnoopsstu: tablespoonfuls, tablespoonsful
bjo: Job, job
aceelnrss: cleansers, clearness
bin: bin, nib
degloss: glossed, godless
cdeikr: Derick, dicker, ricked
bdeilru: builder, rebuild
bdeilrt: Dilbert, driblet
deeoorsv: overdoes, overdose
'acginrs: caring's, racing's
eiorrst: rioters, roister
bnu: bun, nub
'hosw: WHO's, how's, who's
'eersstt: setter's, street's, tester's
eirss: rises, sires
eirst: rites, tiers, tires, tries
cddeei: decide, deiced
eirsw: weirs, wires, wiser
acghinrs: chagrins, crashing
bor: Rob, orb, rob
bbo: Bob, bob
bbi: Bib, bib
aegilnsst: slangiest, tasseling
acghinpt: nightcap, patching
bde: bed, deb
cdeirt: credit, direct
bdu: Bud, bud, dub
degirs: dirges, ridges
'adimnos: Damion's, domain's
aabcfhkls: flashback, halfbacks
cdeilo: coiled, docile
aefls: false, fleas, leafs
aeflr: feral, flare
cgiknor: corking, rocking
aefkr: faker, freak
deginn: ending, ginned
degins: deigns, design, signed, singed
'elmnos: lemon's, melon's
eioprrsu: Superior, superior
bgo: bog, gob
'adenstv: Advent's, advent's
moors: Moors, moors, rooms
degims: midges, smidge
'sttuu: Tutu's, tutu's
degilr: girdle, glider
aagillmnry: alarmingly, marginally
eeginrst: gentries, integers, steering
'eeeinprrsst: Enterprise's, enterprise's
eginr: Niger, reign
aginpprst: strapping, trappings
aefrs: fares, fears, safer
cdeeiinrst: indiscreet, iridescent
aefst: Fates, fates, feast, feats
bru: bur, rub
bsu: UBS, bus, sub
btu: Btu, but, tub
'acilssv: Slavic's, Vlasic's
eiknrst: Kirsten, Kristen, stinker, tinkers
aaceinrsst: ascertains, sectarians
ajy: Jay, jay
ajm: Maj, jam
'giprs: grip's, prig's
efillr: filler, refill
aabrs: Arabs, Basra
aceinooprrt: incorporate, procreation
ail: Ali, Ila, ail
aim: Mai, Mia, aim
ain: Ian, Ina, ani
air: Ira, air
aiv: Iva, via
ahy: Hay, hay
ahm: Ham, ham
ahs: ash, has
agy: Gay, gay
efilny: Finley, finely
'aceeps: Peace's, peace's
gimnpu: impugn, umping
agl: gal, lag
ags: gas, sag
ago: Goa, ago
agp: Gap, gap
gimnsu: Mingus, musing
aiilnoopst: positional, spoliation
anv: Van, van
any: any, nay
anp: Pan, nap, pan
ann: Ann, Nan
ant: Nat, ant, tan
amt: mat, tam
amy: Amy, May, may, yam
eistx: exist, exits
amn: Man, Nam, man
amp: Pam, amp, map
ams: Sam, mas
amr: Mar, arm, mar, ram
efilst: filets, fliest, itself, stifle
beorsst: sorbets, strobes
alw: awl, law
alp: lap, pal
alo: AOL, Lao, Ola
ddeefn: defend, fended
efilrs: fliers, lifers, rifles
efilrt: filter, trifle
eisvw: views, wives
aky: Kay, yak
akr: Ark, ark
abd: bad, dab
ehmorst: Thermos, mothers, smother, thermos
abg: bag, gab
abl: alb, lab
abn: ban, nab
abr: bar, bra
abt: bat, tab
aegilnrst: gnarliest, integrals, triangles
'acsst: cast's, scat's
'eeilss: Elise's, Elsie's
aeegr: agree, eager
eisst: sites, sties
eissu: Susie, issue
eissw: Weiss, wises
eioprsst: prosiest, ripostes
'aeprss: spare's, spear's
'aeprst: prate's, taper's
'ccorssu: crocus's, succor's
acghimnr: charming, marching
aft: aft, fat
ael: Lea, ale, lea
aer: Rae, are, ear, era
aep: ape, pea
aev: Ave, Eva
aet: ate, eat, eta, tea
'adenrrs: Darren's, errand's
cddelos: coddles, scolded
aey: aye, yea
adn: Dan, and
adm: dam, mad
adi: Ida, aid
add: add, dad
dehissw: Swedish, swished
ady: Day, day
ads: ads, sad
adt: Tad, tad
'adenrsw: Andrew's, warden's
acm: Mac, cam
cdehko: choked, hocked
acw: Wac, caw
act: act, cat
acr: RCA, arc, car
aeels: easel, lease
'aemrsst: master's, stream's
ceefir: Recife, fierce
agghiiknnstv: Thanksgiving, thanksgiving
'girsst: grist's, grits's
'aghilmorst: algorithm's, logarithm's
awy: way, yaw
aabem: abeam, ameba
aiinnortu: ruination, urination
'aehlss: leash's, shale's
aeers: erase, saree
'aehlsz: Hazel's, hazel's
'aehlsw: whale's, wheal's
'aehlst: Letha's, lathe's
forst: Frost, forts, frost
arw: raw, war
art: Art, art, rat, tar
ary: Ray, ray
aot: Tao, oat
aabln: Laban, banal
aor: Ora, oar
aabls: balsa, basal
msstu: Smuts, musts, smuts
aeeghimrt: Hermitage, hermitage
apr: Apr, par, rap
aps: SAP, asp, pas, sap, spa
apt: Pat, apt, pat, tap
apy: pay, yap
fopr: Prof, prof
ddeein: denied, indeed
ddeeit: dieted, edited
ddeeir: Deidre, deride
ddeelu: delude, dueled, eluded
ddeelm: meddle, melded
'ahkns: Hank's, Khan's, ankh's, hank's, khan's
ast: Ats, Sat, sat
asw: saw, was
ddeent: dented, tended
ddeenu: denude, endued
ddeenp: depend, pended
'aaegilrs: Algeria's, regalia's
ailnsv: anvils, silvan
ailnst: Latins, Stalin, instal
dsstu: dusts, studs
'aellrsu: Laurel's, allure's, laurel's
'cddeeeeinnnps: Independence's, independence's
aahhoprs: Pharaohs, pharaohs
adelnrs: slander, snarled
ailnps: plains, spinal
ailnpt: plaint, pliant
eelnor: Lenore, Lorene
eghin: hinge, neigh
'aaegmnst: magenta's, magnate's
abceint: Cabinet, cabinet
cdeeinoprv: Providence, providence
emprs: perms, sperm
eills: Ellis, lisle
aiprst: rapist, tapirs
eghins: hinges, neighs
'loopss: sloop's, spool's
eilms: Miles, Selim, limes, miles, slime, smile
'dnos: Don's, don's, nod's
egiilnnst: enlisting, listening, tinseling
aeelnrrs: learners, relearns
beghinrt: berthing, brighten
eikln: Klein, Kline, liken
eiklr: Rilke, liker
'ahlst: halt's, lath's
ceikpst: pickets, skeptic
eikst: kites, tikes
'definrs: finder's, friend's
'ahlsu: haul's, hula's
fhort: forth, froth
aamnosz: Amazons, amazons
ceilnorsu: Cornelius, inclosure
eikps: pikes, spike
'beelrs: Berle's, rebel's
dstuy: Dusty, dusty, study
'rssttu: strut's, trust's
adelopr: leopard, paroled
cdeinrss: discerns, rescinds
'aeemnssttt: statement's, testament's
adelors: loaders, ordeals, reloads
'eilostv: Violet's, violet's
'eilostt: Lottie's, toilet's
ceinorss: Ericsson, necrosis
ailosv: Valois, violas
egorsu: grouse, rogues, rouges
ceknor: Rockne, reckon
egorrs: Rogers, rogers
emoor: Moore, Romeo
emops: Epsom, mopes, poems
emors: Morse, Romes, mores
ttuu: Tutu, tutu
emost: motes, smote, tomes
cceehkr: checker, recheck
adeeirst: readiest, steadier
eimns: miens, mines
deprsu: prudes, pursed
'dllosy: Dolly's, dolly's
eilor: Loire, Lorie
deeilrsv: delivers, silvered, slivered
eilov: Olive, olive, voile
'acelsy: Alyce's, Lacey's
aegginnr: angering, enraging
'opsst: Post's, post's, spot's, stop's
'opssu: opus's, soup's
eilnn: Lenin, linen
eilnt: Intel, inlet
efmorr: former, reform
eilns: liens, lines
eilnv: Elvin, liven
anors: arson, roans, sonar
anosx: Saxon, axons
egipssy: Gypsies, gypsies
'cdeiorrst: creditor's, director's
'ahmss: mash's, sham's
eilps: piles, plies, spiel
'bnorsy: Bryon's, Robyn's
aegginor: Georgian, Georgina
eilst: islet, stile, tiles
eilsv: Elvis, evils, lives, veils
eilsw: Lewis, Wiles, wiles
eilrs: riles, slier
eilrv: liver, viler
aemnprsu: Superman, superman
eenoprs: openers, reopens
ilmnot: Milton, Tomlin
nrstu: runts, turns
'aehnsy: Haney's, hyena's
eilwy: Wiley, Wylie
degilnostu: longitudes, ungodliest
ceelor: Creole, creole
'ceehrs: Cheer's, cheer's
abcelnost: Constable, constable
eellrs: resell, seller
aeiilnst: Taliesin, litanies
eellrt: Teller, retell, teller
'acelms: Camel's, camel's
ceelst: elects, select
'acelns: Lance's, lance's
'eehnorsw: Erewhon's, nowhere's
'chlrsu: churl's, lurch's
acdeeilnrt: credential, interlaced
eellno: Leonel, Noelle
adellnr: Darnell, Randell
deghilt: delight, lighted
'aeeinnorstv: enervation's, veneration's
'emmrssu: Summer's, summer's
'adegilns: dealing's, leading's
emrsu: Remus, serum
cdeeer: decree, recede
instu: Tunis, units
instt: stint, tints
einps: penis, pines, snipe, spine
'bnoos: Bono's, boon's
'aiorssv: Savior's, savior's
ajmor: Major, major
adeeisss: diseases, seasides
'bnoss: bos'ns, snob's
adeeistv: deviates, sedative
cdekost: dockets, stocked
'aelpsst: pastel's, staple's
aeilmsttu: mutilates, stimulate
gnrstu: grunts, strung
achiinrst: Christian, Christina
adehirr: hardier, harried
deimnoot: demotion, motioned
giinrs: rising, siring
giinrv: Irving, virgin
'ahnst: hasn't, shan't
eimst: emits, items, mites, smite, times
'aceils: Alice's, Celia's
frsu: furs, surf
eimrt: merit, miter, remit, timer
eimrs: emirs, mires, miser, rimes
anpss: snaps, spans
anpsw: pawns, spawn
anpsy: Pansy, pansy
'ehiknrst: rethink's, thinker's
cdeesu: deuces, seduce
eoprrst: porters, reports
ghostu: sought, toughs
dhlopu: holdup, uphold
asttw: Watts, watts
'aegopsst: Gestapo's, postage's
'ceiklnrs: clinker's, crinkle's
eiklnw: Winkle, welkin
eiklns: likens, silken
'ceekrs: Creek's, creek's
ailmnr: Marlin, marlin
'adimswy: Midway's, midway's
aenorst: Senator, senator, treason
ailmss: Islams, missal
'aeginnost: Antigone's, negation's
aesstw: sweats, wastes
aesstt: states, tastes
aaccdess: Cascades, cascades
accdeimort: Democratic, democratic
'cdeos: code's, coed's
aessss: assess, sasses
'dors: Rod's, rod's
'ahoss: OHSA's, OSHA's
eiors: Rosie, osier
'doss: DOS's, sod's
'dost: Dot's, Tod's, dot's
'deinrstt: Trident's, trident's
aceerrt: caterer, retrace, terrace
aceertx: exacter, excreta
aaijntu: Juanita, Tijuana
einst: Stein, Stine, inset, nites, stein, tines
einsv: Nevis, veins, vines
einsx: Nexis, nixes
einsw: sinew, swine, wines
ginnoops: snooping, spooning
cceeghiknr: checkering, rechecking
eghhit: eighth, height
einrs: reins, resin, rinse, risen, siren
einrv: ErvIn, riven
einru: inure, urine
einrt: inert, inter, niter
deeiltuy: Yuletide, yuletide
'aehpss: phase's, shape's
eintu: unite, untie
eoprstt: potters, protest, spotter
eoprstu: Proteus, posture, troupes
'belmrstu: tumbler's, tumbrel's
eginrstw: strewing, wresting
acdeinotu: auctioned, cautioned, education
deglno: Golden, golden, longed
'beehsst: Thebes's, behest's
morsw: Worms, worms
eoprsst: posters, prestos
aimor: Maori, Mario, Moira
aarrtt: Tartar, tartar
abdegr: badger, barged, garbed
adegnrst: dragnets, grandest
effiist: fifties, iffiest
aimms: imams, maims
aefmrr: Farmer, farmer, framer
abdees: debase, seabed
'aarrstt: Tartar's, tartar's
acilopt: Capitol, capitol, optical, topical
loppsy: polyps, sloppy
eelnvy: Evelyn, evenly
ellosstu: outsells, sellouts
abdeos: abodes, adobes
joy: Joy, joy
'ceimssu: cesium's, miscue's
eelnst: Nestle, nestle
eelnss: lenses, lessen
abdelm: ambled, bedlam, blamed, lambed
dginnosu: sounding, undoings
abdelr: Balder, balder, blared
defgiiny: deifying, edifying
aehimpsst: shipmates, steamship
abdekr: barked, braked, debark
aeimrst: Artemis, maestri
defgiiln: Fielding, defiling, fielding
'ffhsu: Huff's, huff's
abdeis: abides, biased
adehioprt: Aphrodite, atrophied
cdegiinrt: crediting, directing
hmsu: hums, mush
eprrssuu: pursuers, usurpers
ist: its, sit
ivy: Ivy, ivy
'epsst: Sept's, pest's, step's
ips: pis, sip
ipt: pit, tip
aakos: Asoka, Osaka
aeorsu: Roseau, arouse
eiopstt: potties, tiptoes
'iorst: riot's, tiro's, trio's
abders: beards, breads, debars
abderv: adverb, braved
emmos: Somme, memos
abinry: binary, brainy
eeeilsstt: sleetiest, steeliest
abelrrsw: brawlers, warblers
acdegiimnt: decimating, medicating
'deilorss: Deloris's, soldier's
'cpsu: CPU's, cup's
aimrs: Maris, amirs
amnorst: matrons, transom
abinot: Bonita, obtain
abinos: Bosnia, bonsai
'aprsst: sprat's, strap's
'adlnoors: Orlando's, Rolando's
aarstt: Tatars, strata
aeflor: Loafer, florae, loafer
ainpt: inapt, paint
ainps: Spain, pains
deelorw: lowered, roweled
'adeoprrst: predator's, teardrop's
eloorst: looters, retools
aaegilnpp: appealing, lagniappe
achloostu: Holocaust, holocaust
aeflrs: falser, flares
aanrstt: rattans, tartans
deelovv: devolve, evolved
bennot: Benton, bonnet
defiiln: infidel, infield
eghilns: English, shingle
cdeemoprss: compressed, decompress
aoopprs: Sapporo, apropos
'delmosy: Melody's, melody's
hlot: Holt, loth
aairt: Atari, Atria, atria, tiara
'eprsy: prey's, pyre's
hllu: Hull, hull
accehn: Chance, chance
aajnp: Japan, japan
acceip: icecap, ipecac
'krstu: Kurt's, Turk's
eelprs: lepers, repels
accems: Meccas, meccas
accenr: Cancer, cancer
ciilost: colitis, solicit
eilorst: loiters, toilers
emnot: Monet, Monte
'ceilnorssu: Cornelius's, inclosure's
ailprs: Aprils, spiral
adeiprr: parried, rapider
adeiprt: partied, pirated
adeiprs: aspired, despair, diapers, praised
cginorsu: coursing, scouring, sourcing
ainrt: Trina, train
gpsyy: Gypsy, gypsy
ainst: antis, saint, satin, stain
aintw: Twain, twain
aintt: Titan, taint, titan
pssu: puss, sups
efrry: ferry, fryer
aefkrs: fakers, freaks
lnoy: Lyon, only
ccdeeehkr: checkered, rechecked
cimprs: crimps, scrimp
aeeilrstt: literates, statelier
aeeilrstv: relatives, versatile
deginnrsu: sundering, undersign
bbginos: gibbons, sobbing
deelnrs: lenders, slender
'aelprsst: Psalter's, plaster's, stapler's
'eehrsst: Esther's, Hester's
'eehrssy: Hersey's, heresy's
'aelprstt: platter's, prattle's
'achors: Roach's, Rocha's, roach's
aceilnnnott: Continental, continental
aaiks: Kasai, Sakai
adeiprst: rapidest, traipsed
gnu: gnu, gun
gmu: gum, mug
bdegiint: betiding, debiting
cceeginort: egocentric, geocentric
bemnrsu: Numbers, numbers
hknu: Kuhn, hunk
'ghnosstu: gunshot's, shotgun's
'achoos: Ochoa's, achoo's
aceilopps: Episcopal, episcopal
aaint: Anita, Tania
got: got, tog
dginoow: Goodwin, wooding
eghiinst: heisting, nighties
aaimr: Maria, maria
aaeemnt: emanate, enemata, manatee
aailv: Avila, avail
aails: Alisa, alias
gtu: gut, tug
bceeehs: beeches, beseech
cersw: crews, screw
cerst: Crest, crest
cersu: Sucre, cures, curse
'ehmorsst: smother's, thermos's
cerru: curer, recur
abgginr: barging, garbing
guy: Guy, guy
certu: cruet, cuter, truce
abilno: Albion, albino
amnopst: postman, tampons
'bdnos: Bond's, bond's
abilmu: Malibu, labium
eeehstt: esthete, teethes
'begrrsu: Burger's, burger's
lops: lops, pols, slop
loot: loot, tool
bbgimno: bombing, mobbing
loop: Polo, loop, polo, pool
eeiilnrst: Listerine, resilient
loos: Oslo, solo
'aeeglst: eaglet's, legate's
'aceilprs: caliper's, replica's
cdeeiorrssv: discoverers, rediscovers
eellprs: respell, speller
deelmor: Demerol, remodel
ailms: Islam, mails
eeeprsw: sweeper, weepers
aillv: Villa, villa
door: door, odor, rood
aerrstt: restart, starter
abceefiilrt: certifiable, rectifiable
doow: Wood, wood
aagmm: gamma, magma
enprstu: punster, punters
dopr: drop, prod
eghinrr: Herring, herring
imr: Mir, rim
imt: MIT, Tim
inp: nip, pin
int: nit, tin
ins: ins, sin
losw: lows, owls, slow
lost: lost, lots, slot
ikn: ink, kin
loss: loss, sols
ikt: Kit, kit
ill: Ill, ill
iln: Lin, nil
'achmrs: March's, charm's, march's
how: how, who
hos: hos, ohs
hot: hot, tho
'ainrsstt: Tristan's, transit's
adeirrt: tardier, tarried
'ceenorssv: conserve's, converse's
aegiinnprt: pertaining, repainting
hno: Hon, Noh
ceilorst: cloister, costlier
adeirst: astride, staider, tirades
eelrsv: levers, revels
aahks: Sakha, Shaka
bbceklorstu: Blockbuster, blockbuster
hjno: John, john
ehiiilnpst: Philistine, philistine
aeknrst: rankest, tankers
hjos: Josh, josh
accgno: Cognac, cognac
ailnv: Alvin, anvil
ailns: nails, slain, snail
aabmnt: Batman, bantam
aimprst: armpits, imparts
ailov: Viola, viola
ailpu: Pauli, pilau
oorsst: roosts, torsos
ahmnopt: Hampton, phantom
'aadlnsv: Vandal's, vandal's
ailrs: lairs, liars, liras, rails
ailru: Lauri, Luria
ailrt: trail, trial
ailrv: rival, viral
ailsv: Silva, vials
ailsu: Laius, Luisa
ailss: Silas, sails, sisal
'cost: Oct's, cot's
ailty: Italy, laity
ailrst: trails, trials
abeeilns: Balinese, baseline
aeimnor: moraine, romaine
cekps: pecks, speck
aeimnrt: minaret, raiment
defilrt: flirted, trifled
aeimnrs: Marines, marines, remains, seminar
cchost: Scotch, scotch
eeffjry: Jeffery, Jeffrey
'abekrrs: Barker's, barker's
aaillmn: Alnilam, Manilla
bdeilrsu: builders, rebuilds
bdeilrst: bristled, driblets
cehillrs: Schiller, chillers
aefinn: Fannie, Fenian
aefinr: Efrain, fainer
est: Set, set
esu: Sue, sue, use
aeginrst: Tangiers, angriest, gantries, ingrates, rangiest
'einssw: sinew's, swine's
'einsst: Stine's, inset's, stein's
eelsty: sleety, steely
aefhrt: Father, father
eor: ore, roe
eow: owe, woe
eelsst: sleets, steels
eelssv: selves, vessel
ccehorst: crochets, crotches
epr: Rep, per, rep
'agimnrs: Ingram's, margin's
erv: Rev, rev
ekn: Ken, ken
abeklnst: blankest, blankets
eky: Key, key
elm: Mel, elm
defhiins: fiendish, finished
cdelru: curdle, curled
aeegimnprt: impregnate, permeating
ems: ems, mes
filst: flits, lifts
eno: Noe, eon, one
enw: new, wen
ent: net, ten
egm: Meg, gem, meg
egl: gel, leg
ego: Geo, ego
egn: Eng, Gen
egp: Peg, peg
aeimnty: amenity, anytime
egr: Ger, erg
eehprs: herpes, sphere
egt: GTE, get
'aelorsvy: layover's, overlay's
aeghilnrt: earthling, haltering, lathering
ehs: hes, she
eip: Pei, pie
eil: Eli, Lie, lei, lie
eflsu: flues, fuels
eflst: felts, lefts
gin: ING, gin
'acdnsy: Candy's, candy's
'aeilns: Aline's, alien's
ghu: hug, ugh
celru: cruel, lucre, ulcer
deoprstu: postured, proudest, sprouted
filnt: Flint, flint
aanssu: Nassau, Susana, saunas
'aeilss: Elisa's, aisle's
aacinort: Croatian, raincoat
'deinorsssw: rowdiness's, wordiness's
'eipprst: Trippe's, tipper's
aeiprsst: pastries, raspiest, traipses
aciltty: cattily, tacitly
abehrst: bathers, breaths
eorsstu: ousters, sourest
eorssty: oysters, storeys
eellrst: retells, tellers
eellrss: Sellers, resells, sellers
acdeelr: cleared, declare
airst: astir, sitar, stair
'inprsst: Sprint's, sprint's
'aeills: Allie's, Leila's, Lelia's
'loops: Polo's, loop's, polo's, pool's
'looss: Oslo's, solo's
'loost: loot's, tool's
'aersst: aster's, stare's
acdeert: catered, created, reacted
aeeimnnortu: enumeration, mountaineer
elnosv: novels, sloven
fry: Fry, fry
fox: Fox, fox
for: for, fro
cemot: Comte, comet
abmnow: Bowman, bowman
elnors: enrols, loners
definrs: finders, friends
amnoott: Ottoman, ottoman
bhiops: Bishop, bishop
fir: Fri, fir
hort: Roth, Thor
aadin: Diana, Nadia, naiad
aailntv: Latvian, valiant
aanrtt: rattan, tartan
hosw: hows, show
host: host, shot
hoos: Soho, shoo
hoop: Pooh, hoop, pooh
ailnrsu: insular, urinals
hops: hops, posh, shop
'aemrsssu: Erasmus's, masseur's
'addemns: Madden's, demand's
aeilmnst: ailments, manliest
'belsstu: bustle's, sublet's
'agnorss: Sargon's, sarong's
beirst: bestir, tribes
beirsu: bruise, buries, busier, rubies
'afknrs: Frank's, frank's
'degios: Diego's, dogie's
'achsty: Cathy's, yacht's
cot: Oct, cot
cox: Cox, cox
coy: Coy, coy
bddeeit: betided, debited
'degirs: dirge's, ridge's
aeehirrt: earthier, heartier
censt: cents, scent
ehrtz: Hertz, hertz
cdo: cod, doc
eehrsw: hewers, wheres
eehrst: Esther, Hester, threes
eehrsy: Hersey, heresy
bbinor: Robbin, ribbon
cenor: Creon, crone
chi: Chi, chi
cenos: cones, scone
aaeehhimprstt: amphitheaters, amphitheatres
'aeijms: Jaime's, Jamie's, Mejia's
aekrsty: Starkey, streaky
aaemnst: Eastman, Smetana
aabcdkrsw: backwards, drawbacks
hnsu: Huns, shun
aailmrt: Martial, marital, martial
aailmss: Salamis, salamis
bbgiinr: bribing, ribbing
aekrsst: skaters, streaks
efz: Fez, fez
efr: fer, ref
ailnsty: nastily, saintly
eel: Lee, eel, lee
hnor: Horn, horn
eew: ewe, wee
eev: Eve, eve
dstu: dust, stud
'ijnorsu: Junior's, junior's
aaclr: Carla, Clara
aacnz: Anzac, Nazca
lstu: lust, slut
aiprs: Paris, Parsi, pairs
'abeglns: Bengal's, bangle's
'abeglms: Gamble's, gamble's
aailmns: Malians, Manilas, animals
dor: Rod, rod
dot: Dot, Tod, dot
dos: dos, sod
eeeinprrst: Enterprise, enterprise
'eeggirs: Geiger's, Reggie's
aeggjnrtuu: Juggernaut, juggernaut
dno: Don, don, nod
accdeilnost: Occidentals, occidentals
aabddlns: Badlands, badlands
'eginrs: Niger's, reign's
cdeors: credos, decors, scored
giiklnn: inkling, kilning, linking
ceirsstu: citruses, curtsies
dgo: God, dog, god
der: Red, red
dew: Wed, dew, wed
def: Fed, fed
del: Del, led
den: Ned, den, end
deo: Doe, doe, ode
acceemnorsttu: accouterments, accoutrements
ceors: cores, score
ceory: Corey, Royce, coyer
ccehosst: Scotches, scotches
dim: dim, mid
din: Ind, din
dis: Dis, Sid, dis, ids
ceops: Pecos, copes, copse, scope
hntu: Hunt, hunt
'akmnorsw: Workman's, workman's
celoost: coolest, ocelots
'beffrsu: buffer's, rebuff's
aeginnst: antigens, gentians
aeginnsu: Guineans, sanguine
biorst: bistro, orbits
aeginnrs: earnings, grannies
acghiilmort: algorithmic, logarithmic
cehil: Chile, chile
cehir: Cheri, Erich, Reich
diks: disk, kids, skid
dikr: Dirk, dirk
dils: lids, slid
ammmno: Mammon, mammon
alotuy: layout, outlay
dily: idly, idyl
'cosst: Scot's, cost's
deeelnss: lessened, needless
dino: Dino, Dion, Odin
diov: Ovid, void
abdnru: Dunbar, Durban
abdnry: Brandy, brandy
'aeginnst: antigen's, gentian's
aginostt: Tsingtao, toasting
aeginnot: Antigone, negation
beilmo: Mobile, mobile
aagjru: Jaguar, jaguar
aggginn: ganging, nagging
'aahkss: Sakha's, Shaka's
'eghilnss: English's, shingle's
'elors: lore's, role's
agnost: Sontag, tangos
'elosv: Love's, love's, vole's
'eloss: sloe's, sole's
deooprst: doorstep, torpedos
'eoqstu: quote's, toque's
'beinrstu: tribune's, turbine's
aehknrs: hankers, harkens
aabcdeorrst: broadcaster, rebroadcast
'elops: Opel's, Pole's, lope's, pole's
agnors: Sargon, groans, organs, sarong
'aeehinrssst: earthiness's, heartiness's
'eillstt: Little's, little's
aefmnor: Foreman, foreman
ceelrstu: cruelest, lectures
'einpss: penis's, snipe's, spine's
'ginors: Ringo's, groin's
bgrsu: burgs, grubs
beehop: Phoebe, phoebe
'emrssu: Remus's, serum's
giiknnp: kingpin, pinking
giiknps: pigskin, spiking
dhos: hods, shod
dhoo: Hood, hood
oorst: roost, roots, torso
'aansssu: Nassau's, Susana's
'aklrs: Karl's, lark's
'ellosvy: lovely's, volley's
abdors: boards, broads
aaceilrsv: cavaliers, cavalries
aginorst: organist, roasting
aartt: Tatar, attar
cdelnoos: condoles, consoled
ciinnoostttu: Constitution, constitution
aginorrs: Garrison, garrison
beehst: Thebes, behest
ahlorw: Harlow, Warhol
acdeirr: acrider, carried
cehst: chest, techs
'ehlls: Hell's, hell's, she'll
innosu: Unions, unions, unison
'elnos: Leno's, Noel's, Olen's, noel's
deloot: Toledo, looted, tooled
abelmrs: marbles, rambles
deloos: loosed, oodles, soloed
deloop: looped, poodle, pooled
aceehrst: cheaters, hectares, teachers
'ceirssu: Cruise's, cruise's
aceehrrs: research, searcher
delors: resold, solder
cehlw: Welch, welch
delosw: dowels, slowed
cimmnnoou: Communion, communion
cehno: Cohen, Enoch
cehos: chose, echos
cehor: Roche, chore, ocher, ochre
adeforrstw: afterwords, forwardest
acdeilm: claimed, decimal, declaim, medical
acdeilt: citadel, dialect
beimrt: timber, timbre
bgggilno: blogging, boggling
'aacorsttu: actuator's, autocrat's
bcehrstu: Schubert, butchers
'cdeikrrs: Derrick's, derrick's
dgir: gird, grid
aghnnstu: Shantung, shantung
aginoprrt: parroting, prorating
dgoo: Good, good
dgos: dogs, gods
'blmoos: Bloom's, bloom's
'ddeilrs: Riddle's, riddle's
acdehrs: Schedar, crashed
abegilnt: bleating, tangible
cemprstu: crumpets, spectrum
aistw: waist, waits
'elmos: Elmo's, Lome's, mole's
beinno: Bonnie, bonnie
psu: pus, sup, ups
acdehmr: charmed, marched
'deiinnosstt: distention's, tendonitis's
ehnorst: hornets, shorten, thrones
ceitv: civet, evict
'abceilnprsu: Republican's, republican's
ceirs: cries, rices
ceiru: Curie, curie
bdemoor: bedroom, boredom
ceipr: Price, price
ceips: epics, spice
'bdeist: bidet's, debit's
acegimnr: Germanic, creaming
beelrt: Elbert, treble
aefsst: feasts, safest
'einoprst: pointer's, protein's
einoprst: pointers, proteins
adeemnrst: smartened, tradesmen
cekos: Cokes, cokes
'beimrst: timber's, timbre's
'ehirs: heir's, hire's
eeehlrw: Wheeler, wheeler
'afrst: fart's, frat's, raft's
adlnoor: Orlando, Rolando
aafghns: Afghans, afghans
cdeiinnoort: conditioner, recondition
dfor: Ford, ford
'einrss: resin's, rinse's, siren's
ehjops: Joesph, Joseph
adeforrtw: Waterford, afterword
'ellsy: Lyle's, yell's
'bhiopss: Bishop's, bishop's
admnos: damson, nomads
admnoy: Monday, dynamo
cceilrs: circles, clerics
bginnorw: Browning, browning
ceoorstuu: courteous, outsource
aaginu: Guiana, iguana
acegimnrt: centigram, cremating
abelort: Alberto, Latrobe
'ceehillns: Hellenic's, chenille's
cehnorv: Chevron, chevron
acdegln: clanged, glanced
'aaimnrs: Armani's, Marina's, airman's, marina's
'deeenrrsv: Reverend's, reverend's
'aalmrs: Lamar's, Marla's, alarm's
aceginrt: catering, creating, reacting
delmpu: lumped, plumed
aamrstu: Sumatra, traumas
'ceenrss: censer's, screen's
aabdor: Baroda, aboard, abroad
cinosst: consist, tocsins
aefrst: faster, strafe
adeinnoostt: denotations, detonations
'aaglnos: Angola's, analog's
delmos: models, seldom
delmoy: Melody, melody
dfnosu: fondus, founds
cirstu: Curtis, citrus, rustic
hitw: whit, with
celosst: closest, closets
hiss: Hiss, hiss
hist: hits, shit, this
eprsttu: putters, sputter
aceorrt: Creator, creator, reactor
aagnor: Angora, angora
hims: hims, shim
dmoo: Odom, doom, mood
'eenrsstw: Western's, western's
hill: Hill, hill
beinorsw: Brownies, brownies
eeeinprrrstt: interpreters, reinterprets
'abbels: Babel's, babel's
'abbcelrss: Scrabble's, scrabble's
hips: hips, ship
adeoprrty: portrayed, predatory
'achmos: macho's, mocha's
'akors: Karo's, okra's
adeoprrst: predators, teardrops
hint: hint, thin
'elsuy: Yule's, yule's
'elsvy: Levy's, levy's
acdenst: decants, descant, scanted
einoprt: pointer, protein
ntu: nut, tun
abdirs: braids, disbar
nsu: Sun, sun
aloprt: patrol, portal
nru: run, urn
dnos: dons, nods
aerss: Sears, sears
aerst: aster, rates, stare, tares, tears
aersy: Ayers, years
aersw: swear, wares, wears
aersv: avers, raves, saver
aerrs: Serra, rares, rears
not: not, ton
nos: Son, son
nor: Ron, nor
now: now, own, won
aefhrst: Fathers, fathers
'ehoss: hose's, shoe's
ehhoopsty: Theosophy, theosophy
'aeginrst: granite's, ingrate's
'achnors: Charon's, anchor's
'acdelnors: Calderon's, colander's
'aeklrsw: Walker's, walker's
abdilr: bridal, ribald
adeenr: earned, endear, neared
celortu: Coulter, cloture
celorsv: Velcros, clovers
aeilmttu: mutilate, ultimate
aeirsstt: artistes, artsiest
adeers: erased, seared
adeerr: dearer, reader, reared, reread
adeesv: deaves, evades
adeest: seated, sedate, teased
'enosst: onset's, stone's
dlot: dolt, told
dlor: Lord, lord
'acers: acre's, care's, race's
adeefr: deafer, feared
giiklnns: inklings, slinking
adeegr: agreed, geared
'aalsss: Lassa's, Salas's, salsa's
'aalsst: Atlas's, atlas's
adeehr: adhere, header
'acess: Case's, case's
'bhssu: Bush's, bush's
adeelp: leaped, pealed
adeeln: leaden, leaned
adeels: leased, sealed
adeelr: dealer, leader
'ahmrss: Marsh's, marsh's
aanst: Santa, Satan
adeemr: reamed, remade
blmoo: Bloom, bloom
'beerrsw: Brewer's, brewer's
'elrsu: lure's, rule's
acdemor: Mercado, caromed, comrade
otw: tow, two, wot
ceeeilstv: electives, selective
'acels: Alec's, lace's
'acems: acme's, mace's
'acens: acne's, cane's
'aceps: Pace's, cape's, pace's
opt: opt, pot, top
ort: rot, tor
aestt: state, taste, teats
aesty: Yates, Yeats, yeast
aestv: Vesta, stave
cgiinnoot: cognition, incognito
aestx: Texas, taxes
aestw: sweat, waste
aessv: saves, vases
aesst: Easts, Tessa, asset, sates, seats
'hisss: Hiss's, hiss's
acnorst: cantors, cartons
beegrr: Berger, Gerber
ginoppst: stopping, toppings
ccdeenort: concerted, concreted
aeort: Erato, orate
cnors: corns, scorn
cnory: corny, crony
adeeimnnot: denominate, emendation
adefrt: dafter, farted, rafted
ciimosst: Stoicism, stoicism
adefry: defray, frayed
bdeit: bidet, debit
'enorss: Norse's, snore's
aaglno: Angola, analog
aamnn: Annam, manna
'akmrs: Mark's, mark's
bdegu: budge, debug
aeefmnr: Freeman, freeman
deeirssu: reissued, residues
adeflr: Alfred, flared
bdelu: blued, lubed
aamru: Amaru, Maura
adeflo: foaled, loafed
'aacellmrs: Carmella's, Marcella's
aamrt: Marat, Marta, Tamra
acdemno: Caedmon, Macedon
adefmr: farmed, framed
aamss: Assam, amass
'ciorstv: Victor's, victor's
'ekorsst: stoker's, stroke's
bdery: Derby, derby
gorss: Gross, gross
adefil: afield, failed
bdeor: bored, robed
adefir: Freida, Frieda
aelpsst: Staples, pastels, staples
cdeeoprrsu: procedures, reproduces
aacdeemrt: demarcate, macerated
ceekr: Creek, creek
lop: lop, pol
abelrst: blaster, stabler
los: Sol, sol
lot: Lot, lot
low: low, owl
'aennorss: Rosanne's, Roseann's
adeggt: gadget, tagged
adeggr: dagger, ragged
abelrrw: brawler, warbler
'achrs: arch's, char's
adeggn: ganged, nagged
ceehr: Cheer, cheer
'achst: ACTH's, chat's
bdetu: debut, tubed
'achps: Caph's, chap's
lsstu: lusts, sluts
'aeelprsstt: saltpeter's, saltpetre's
einprrst: printers, reprints, sprinter
acdelps: clasped, scalped
benoor: Borneo, Oberon
aefhilsst: faithless, flashiest
ceert: Crete, erect
'aahnnss: Anshan's, Shanna's
ceepr: creep, crepe
acillopty: optically, topically
benort: Breton, Bronte
'ehikrss: shriek's, shrike's
celsttu: cutlets, scuttle
berstu: brutes, buster, rebuts, tubers
aeprt: Petra, apter, prate, taper
aeprs: pares, parse, pears, rapes, reaps, spare, spear
aepry: Peary, payer, repay
aepst: paste, pates, septa, spate, tapes
dginy: dingy, dying
dgino: dingo, doing
'aknsy: Yank's, yank's
aally: Layla, allay
adegrr: Gerard, grader, regard
'eeiinoprstt: petitioner's, repetition's
'aknst: Kant's, tank's
aalmr: Lamar, Marla, alarm
ceefprt: perfect, prefect
aalpu: Palau, Paula
aelprtt: platter, prattle
adegnr: danger, gander, garden, ranged
aalpp: appal, papal
efhiisstt: fetishist, shiftiest
'aknrs: nark's, rank's
aelprst: Psalter, plaster, stapler
aelprsy: parleys, parsley, players, replays, sparely
adeglr: Gerald, glared
adegln: Glenda, angled, dangle
aalru: Laura, aural
ailnstuu: Nautilus, nautilus
dgirs: girds, grids
aalss: Lassa, Salas, salsa
aalst: Atlas, atlas
deiklns: kindles, slinked
'achins: China's, Icahn's, chain's, china's
abelstt: battles, tablets
mot: Tom, tom
acdehlnr: Chandler, chandler
eeeprrsv: perverse, preserve
bdduy: Buddy, buddy
deiinnostt: distention, tendonitis
cefhi: chief, fiche
egiinprsst: persisting, springiest
eipsss: pisses, sepsis
acilnor: Conrail, clarion
abdlry: Bradly, drably
aaagimrrt: Margarita, margarita
'elpsy: Pyle's, yelp's
abdeeiknrrw: Windbreaker, windbreaker
'fnostu: fount's, futon's
giilnqsu: Quisling, quisling
aefnst: Stefan, fasten
eehinr: herein, inhere
emnorst: mentors, monster
'oosst: Soto's, soot's
'ciimossst: Stoicism's, stoicism's
aeflrsu: earfuls, refusal
'aaeehhimprstt: amphitheater's, amphitheatre's
'oostt: Toto's, toot's
eipqsu: equips, piques
'airsstt: artist's, strait's
fgiilnrt: flirting, trifling
aceilprs: calipers, replicas
eegginnr: greening, reneging
aejprs: Jasper, jasper
acdehnst: snatched, stanched
'cekps: Peck's, peck's
eeimprsss: impresses, premisses
'eprssu: purse's, super's
adeiss: asides, daises
adeisv: Davies, advise, visaed
'cekos: Coke's, coke's
'adeilsttu: altitude's, latitude's
'cffils: Cliff's, cliff's
aenoprsttt: Protestant, protestant
adeipr: diaper, paired, repaid
aacinorst: Croatians, raincoats
adeinr: Andrei, rained
adeinn: Dannie, Dianne, Nadine
aegnors: Onsager, oranges
iorst: riots, tiros, torsi, trios
'acehrss: chaser's, search's
'accdeefnorsy: Confederacy's, confederacy's
belmorsy: somberly, sombrely
'agost: goat's, toga's
iorvy: Ivory, ivory
iknos: ikons, oinks
beerrw: Brewer, brewer
aeekorstv: overtakes, takeovers
eillnst: lentils, lintels
'acdemnos: Caedmon's, Macedon's
belmstu: stumble, tumbles
iknss: sinks, skins
iknst: knits, stink
'oorst: Oort's, Root's, root's
eiprst: Sprite, priest, ripest, sprite, stripe
cgimmnsu: Cummings, scumming
aeinrrsst: restrains, strainers
adeilm: Imelda, mailed, medial
adeiln: Daniel, alined, denial, nailed
adeils: ideals, ladies, sailed
adeilt: detail, dilate, tailed
adeilr: derail, railed, relaid
adeimn: Damien, Medina, maiden, median
eillmt: Millet, millet
eillmr: Miller, miller
deeprtu: erupted, reputed
eillnt: lentil, lintel
'abgrs: brag's, garb's, grab's
amrst: marts, smart, trams
amrsw: swarm, warms
cenoorr: coroner, crooner
adehps: phased, shaped
'ceglnoos: Cologne's, cologne's
aelorvy: layover, overlay
adehss: dashes, shades
adehst: deaths, hasted
deeprss: depress, pressed
'egiorst: goiter's, goitre's
adehrt: dearth, hatred, thread
'celsu: Luce's, clue's
adehrr: Erhard, harder
eillvy: evilly, lively, vilely
adehms: mashed, shamed
aaceillprrt: Caterpillar, caterpillar
adehln: Handel, handle
adehlt: halted, lathed
eilltt: Little, little
aelorrt: Realtor, realtor
aceilrst: articles, recitals
'eeprst: Peter's, peter's
'eeprsu: puree's, rupee's
'eeprss: Speer's, spree's
'eelrsstt: settler's, trestle's
'eelrsstw: swelter's, wrestle's
noopss: snoops, spoons
noopsy: Snoopy, snoopy
nooprt: pronto, proton
belmrtu: tumbler, tumbrel
belmrsu: lumbers, rumbles, slumber
'aglnos: Golan's, Logan's
eeeinprrrtt: interpreter, reinterpret
aacellmr: Carmella, Marcella
'eillnst: lentil's, lintel's
dginos: doings, dosing
amost: Tomas, atoms, moats
aceinorst: creations, reactions
dehrss: sherds, shreds
amoru: Mauro, amour
amors: Ramos, roams
amory: mayor, moray
adelno: Delano, loaned
adelnr: Lenard, lander
aaceenrs: Cesarean, cesarean
adelor: Laredo, loader, ordeal, reload
eilmps: impels, simple
blost: blots, bolts
blosw: blows, bowls
'aimosst: Maoist's, Taoism's
adelms: damsel, medals
aaacmrs: maracas, mascara
adelrr: Darrel, larder
'cenos: cone's, once's
adelst: deltas, lasted, salted, slated, staled
adelsv: salved, slaved
adelps: lapsed, pedals, pleads
adelpp: dapple, lapped
'ciosst: Stoic's, stoic's
adekst: skated, staked, tasked
hills: hills, shill
'aefmrrs: farmer's, framer's
efhiinrs: finisher, refinish
aceilsst: Alcestis, elastics, scaliest
'most: Tom's, tom's
'fisstw: Swift's, swift's
eglopss: Gospels, gospels
aabcdeorrsst: broadcasters, rebroadcasts
aeeintttv: attentive, tentative
'abils: Bali's, bail's
eipprt: Trippe, tipper
eeeinprrsst: enterprises, intersperse
'iorsvy: Ivory's, ivory's
'gstu: gut's, tug's
'gsuy: Guy's, guy's
'cehors: Roche's, chore's, ocher's, ochre's
aeehinrsst: earthiness, heartiness
aeeilmnnt: alinement, lineament
adeennrs: Andersen, ensnared
ampst: stamp, tamps
'ceost: Cote's, cote's
einnost: intones, tension
adeginrt: gradient, treading
einnoru: Reunion, reunion
eilnos: insole, lesion
eilnor: Elinor, Lenoir
eilnpu: lineup, lupine
adekns: kneads, snaked
adeknr: Kendra, danker, darken, narked, ranked
'ceinnnost: Innocent's, innocent's
eilnno: Lonnie, online
llorst: stroll, trolls
aaaceenrs: Caesarean, caesarean
'kmnos: Monk's, monk's
'ceops: OPEC's, cope's
'aceehrst: cheater's, hectare's, teacher's
adejrr: Jarred, jarred
himst: Smith, smith
accdeilnot: Occidental, occidental
bckllou: Bullock, bullock
eilnsv: livens, snivel
afnsu: fauns, snafu
eilnst: enlist, inlets, listen, silent, tinsel
adhiloy: Holiday, holiday
'aeekmrs: Kareem's, remake's
'acinosss: caisson's, cassino's
afnny: Fanny, fanny
cdeginnos: consigned, seconding
'agnss: Sang's, snag's
'agnst: gnat's, tang's
'aeilnorst: Oriental's, oriental's, relation's
eimnstu: minuets, minutes
eimnstt: mittens, smitten
'acinostu: auction's, caution's
'acehsst: Scheat's, sachet's
rsttu: strut, trust
adenwy: Dwayne, yawned
'agllos: Algol's, Gallo's
'aeilmnns: lineman's, melanin's
rstuy: Rusty, rusty
adentv: Advent, advent
adenrt: ardent, ranted
adenru: Neruda, unread
adenrr: Darren, errand
adenrs: Andres, sander, snared
aceillop: Calliope, calliope
adenrw: Andrew, wander, warden, warned
'ceos: CEO's, Eco's
adenpp: append, napped
adenpt: panted, pedant
adenot: atoned, donate
deossyy: Odyssey, odyssey
aaceiilnprstt: antiparticles, paternalistic
deooprt: torpedo, trooped
'acehnrssuz: Schnauzer's, schnauzer's
egos: egos, goes
egor: Gore, Roeg, ergo, gore, ogre
'ilnosst: Liston's, tonsil's
egry: Grey, grey
adeginprt: departing, predating
adeginprv: depraving, pervading
egln: Glen, glen
eglo: Lego, loge, ogle
egls: gels, legs
'abkls: Kalb's, balk's
'hjnos: John's, john's
egms: gems, megs
aegiinnrstt: reinstating, straitening
ehnrtu: Hunter, hunter
adejrstu: adjuster, readjust
'aehrssw: hawser's, washer's
acorst: Castor, Castro, Croats, actors, castor, costar, scrota
acorss: Oscars, across
dggginru: drugging, grudging
'aehrstt: hatter's, threat's
ceinorstu: countries, cretinous, neurotics
efglors: Folgers, golfers
'aemorrssy: Rosemary's, rosemary's
hinst: hints, thins
aemnrst: martens, smarten
aemnrsu: manures, surname
acillost: Callisto, Castillo
'aaailnrsstu: Australian's, Saturnalia's
'eejlsw: Jewel's, jewel's
abdeorr: boarder, broader
ademsu: Medusa, amused
belmoor: Bloomer, bloomer
'aillorstt: littoral's, tortilla's
'cdos: cod's, doc's
dgiinr: Ingrid, riding
eillrst: stiller, tillers, trellis
aceilmrs: miracles, reclaims
adegilnp: pedaling, pleading
ademno: daemon, moaned
adegilns: dealings, signaled
aceilmst: clematis, climates
aceilmsx: climaxes, exclaims
iinppp: Pippin, pippin
'hoosst: shoot's, sooth's
'elpssu: Lepus's, pulse's
aceinosst: canoeists, cessation
'almors: molar's, moral's
ceehilln: Hellenic, chenille
ehss: Hess, shes
aeflors: Loafers, loafers
adlnpu: Dunlap, upland
adlnor: Arnold, Roland, Ronald
'ablms: balm's, lamb's
kloootu: lookout, outlook
ehop: Hope, hope
ehos: hoes, hose, shoe
ehnw: hewn, when
eeglnorstt: Longstreet, lorgnettes
ehms: hems, mesh
ehll: Hell, hell
'cekrstu: Tucker's, tucker's
deeiinsst: densities, destinies
aginnttu: attuning, taunting
'aacdhnrs: Chandra's, handcar's
ceiinnopst: inceptions, inspection
ehir: heir, hire
beinrtu: tribune, turbine
beinrtt: Britten, bittern
aegnrst: Sargent, garnets, strange
'aalppsy: PayPal's, Paypal's
ddeloor: doodler, drooled
aegnrrs: garners, rangers
aflot: aloft, float
aflos: foals, loafs
aflor: Flora, flora
acosst: ascots, coasts
isttu: Titus, Tutsi
isttw: twist, twits
'aceinssstt: cattiness's, tacitness's
abdennr: Branden, Brendan
eesw: ewes, wees
'ijnos: Joni's, join's
'aadins: Diana's, Nadia's, naiad's
aceilnor: Caroline, Cornelia
'bhrssu: brush's, shrub's
agnrty: Gantry, gantry
'acinopst: Pontiac's, caption's
eeks: ekes, seek
eekn: keen, knee
eekl: Klee, keel, leek
eekp: keep, peek
'cersu: cure's, ecru's
ikmns: Minsk, minks
eelp: Peel, Pele, peel
eels: eels, else, lees
eelr: leer, reel
eemt: meet, mete, teem
'bdenorsu: bounder's, rebound's
adepst: adepts, pasted
adepss: passed, spades
giinnprst: printings, sprinting
'acdemors: Mercado's, comrade's
adeprs: drapes, padres, parsed, rasped, spared, spread
adeprt: depart, parted, petard, prated
eeps: pees, seep
emoorr: Romero, roomer
eenprsst: pertness, presents, serpents
aalmnoy: Layamon, anomaly
'aanrstt: rattan's, tartan's
adeginrrw: redrawing, rewarding
ailmrstu: altruism, muralist
eerv: ever, veer
eerw: ewer, weer, were
eery: Eyre, eery
adeppr: dapper, rapped
eers: Erse, seer, sere
eefr: free, reef
'acelrst: cartel's, claret's
eefl: feel, flee
eehr: Rhee, here
eegn: Gene, gene
eejp: Jeep, jeep
'efhlss: flesh's, shelf's
ciprs: crisp, scrip
'ehoorsst: Hooters's, shooter's
eeir: Eire, Erie
egoprru: grouper, regroup
aaeilrv: Valarie, Valeria
'aefhrst: Father's, father's
afknr: Frank, frank
'inpstu: Putin's, input's
bhoot: Booth, booth
'defiilns: infidel's, infield's
adeisswy: sideways, waysides
adeors: adores, soared
bhort: broth, throb
belmmru: Brummel, mumbler
adeisstt: distaste, staidest
efilrst: filters, trifles
'aaffirs: affair's, raffia's
accgikln: cackling, clacking
aabceilrt: bacterial, calibrate
iklns: kilns, links, slink
'dhimorsu: humidor's, rhodium's
iklls: kills, skill
efnr: Fern, Nerf, fern
osttu: Stout, stout, touts
beeorsv: observe, obverse, verbose
efry: Frey, Frye
eggiknos: gingkoes, ginkgoes
efrs: refs, serf
ioqtu: Quito, quoit
eimrssu: mussier, surmise
effi: fief, fife
eflu: flue, fuel
ciopt: optic, topic
eflt: Left, felt, left
'abnrs: Bran's, barn's, bran's
'isttw: Witt's, twit's
ehnost: Heston, honest
'celorsv: Velcro's, clover's
bsstu: busts, stubs
ciost: Stoic, stoic
efir: fire, rife
efil: Leif, file, lief, life
efin: Enif, fine
'ekrstuy: Turkey's, turkey's
eeinrsstt: interests, triteness
boost: boost, boots
ehnort: Theron, hornet, throne
'eiknrstt: knitter's, trinket's
'eiknrsst: Kirsten's, Kristen's, stinker's
adeeeglrv: everglade, leveraged
iiiinnoqstu: Inquisition, inquisition
acorsst: castors, costars
afilr: flair, frail
aenprst: Napster, entraps, parents, pastern
cdeiorsv: discover, divorces
abeinnrst: Bannister, bannister
cdeiorrt: creditor, director
eehsst: sheets, theses
dehlru: hurdle, hurled
cehoprs: Porsche, porches
eegimnrt: metering, regiment
'acmors: Marco's, carom's, macro's
aderstw: steward, strawed
aderstv: adverts, starved
eeeioprrrst: repertoires, repertories
'acelprs: carpel's, parcel's, placer's
cenosstu: contuses, countess
ginrtu: Turing, truing
'aeennstt: Annette's, Nanette's
ehost: ethos, those
ehoss: hoses, shoes
ehosu: House, house
abdsu: bauds, daubs
'acilnors: Conrail's, clarion's
ceillor: Collier, collier
ehort: other, throe
ehors: heros, horse, shore
'glpsu: gulp's, plug's
'aaprsst: Sparta's, satrap's
'acosst: Tosca's, ascot's, coast's
'ceiprrsstu: Scripture's, scripture's
'eensss: Essen's, sense's
ceilmop: compile, polemic
eilsst: islets, sliest, stiles
egillnnotw: Wellington, wellington
abdry: Brady, Darby
eilstv: livest, vilest
abdrs: bards, brads, drabs
aderrt: retard, tarred, trader
abdor: board, broad
'acelosv: alcove's, coeval's
aderrw: drawer, redraw, reward, warder, warred
aderst: stared, trades, treads
adersw: Seward, waders
'acelors: Carole's, Oracle's, oracle's
abdes: based, beads
abder: Beard, Debra, bared, beard, bread, debar
abdey: bayed, beady
abdel: baled, blade
'aeilsss: Lassie's, lassie's
abdeo: abode, adobe
dehlor: Holder, holder
mprtu: Trump, trump
afirs: Farsi, fairs
abdir: Baird, braid, rabid
efilort: loftier, trefoil
eegiinnnrtv: intervening, reinventing
efhls: flesh, shelf
elpprsu: purples, suppler
aeffknrrrtu: Frankfurter, frankfurter
'bbcelors: clobber's, cobbler's
afhit: Faith, faith
'eggilrsw: wiggler's, wriggle's
aeeimsstt: estimates, steamiest
achimnost: Macintosh, macintosh
elrsy: lyres, slyer
elrsu: lures, rules
bbdeir: bribed, ribbed
deeorrst: resorted, restored
'adegnrs: danger's, gander's, garden's
'acorst: Croat's, actor's
'ehnorssttw: Northwest's, northwest's
moorrw: Morrow, morrow
agghiiknnsstv: Thanksgivings, thanksgivings
deggiln: gelding, niggled
'gmsu: gum's, mug's
abemr: Amber, amber
abenr: Abner, Arneb
abens: banes, beans
acfils: califs, fiscal
bcmos: Combs, combs
grsu: Grus, rugs
opsstu: spouts, tossup
bbdemo: bombed, mobbed
'hrssu: Rush's, rush's
egginr: Ginger, ginger, nigger
abers: Sabre, bares, baser, bears, saber, sabre
aberr: Berra, barer
'hrstu: Ruth's, hurt's
abest: Bates, abets, baste, bates, beast, beats, betas
abesu: abuse, beaus
cemrruy: Mercury, mercury
cdeiilosu: Delicious, delicious
eggiln: leggin, neglig, niggle
aacdhnr: Chandra, handcar
abbbdel: babbled, blabbed
aacorttu: actuator, autocrat
abegl: Gable, bagel, gable
'aelmnst: Mantle's, lament's, mantel's, mantle's
aaeiilnorstt: Aristotelian, retaliations
deimoost: moodiest, sodomite
abdeirs: braised, seabird, sidebar
abehr: Brahe, Haber, rehab
fnotu: fount, futon
afhst: hafts, shaft
abdeilp: bipedal, piebald
'bbbosy: Bobby's, bobby's
efgor: forge, gofer
abekl: Blake, bleak
abekr: Baker, baker, brake, break
abeks: bakes, beaks
aaegsssu: assuages, sausages
'aghss: gash's, shag's
aeinnosst: Estonians, sensation
beinrstu: tribunes, turbines
abdeinr: Brandie, bandier, brained
abelm: Mabel, Mable, Melba, amble, blame
abell: Bella, label
abels: Basel, bales, sable
abelr: abler, blare
abelt: bleat, table
ckrstu: struck, trucks
efils: files, flies
efilr: flier, lifer, rifle
dllory: drolly, lordly
aimmos: Maoism, Mimosa, mimosa
abdemru: Bermuda, rumbaed
efinr: finer, infer
ehossttuw: Southwest, southwest
ghiintt: hitting, tithing
ehmny: Hymen, hymen
ceilnst: clients, stencil
deorru: dourer, ordure
'bills: Bill's, bill's
cehorst: hectors, torches
deorsu: roused, soured
deorst: Dorset, sorted, stored, strode
'deinssty: density's, destiny's
ehmor: Homer, homer
'aacflrst: flatcar's, fractal's
deortu: detour, routed, toured
'aaimnssst: Satanism's, satanism's
ehlsw: Welsh, welsh
adejrsstu: adjusters, readjusts
eforrst: Forrest, Forster
abiklmns: lambkins, lambskin
'ceikrsst: rickets's, sticker's
goop: Pogo, goop
gory: gory, gyro, orgy
abbel: Babel, babel
celnoy: Ceylon, Conley
'aeinsv: Evian's, Nivea's
aaclrss: rascals, scalars
abdelst: baldest, blasted, stabled
aemnors: enamors, oarsmen
abdelrw: brawled, warbled
aaegstwy: gateways, getaways
cderstu: crudest, crusted
'hosstu: South's, shout's, south's
aaclrvy: Calvary, cavalry
aeehorssuw: housewares, warehouses
aimnrt: Martin, martin
aimnst: mantis, matins
aderrsw: drawers, redraws, rewards, warders
aderrst: retards, starred, traders
abdelmr: marbled, rambled
'abrsy: Bray's, bray's
aeimnnost: Minnesota, nominates
ademnnu: mundane, unnamed
adddeemn: demanded, maddened
elpsu: Lepus, pulse
elpst: pelts, slept, spelt
aehinpst: Thespian, thespian
dehiss: dishes, hissed
'abdennrs: Branden's, Brendan's
'cnoostt: Cotton's, cotton's
ademnru: manured, maunder, unarmed
deossu: douses, soused
'ckors: Kroc's, cork's, rock's
ehnor: Horne, Rhone, heron
ehnos: hones, shone
emossu: mouses, mousse
deosux: Exodus, exodus
eikmors: irksome, smokier
eehirrs: Sherrie, rehires
ceilppr: clipper, cripple
adestt: stated, tasted
adesty: stayed, steady
abcno: Bacon, bacon
adeiils: dailies, liaised
'ehorss: horse's, shore's
aaenpsst: anapests, peasants
'acellrs: caller's, cellar's, recall's
abckl: Black, black
dlloy: Dolly, Lloyd, dolly
abceh: Beach, beach
'aeilrss: Israel's, serial's
abcel: Caleb, cable
aaeilmnprt: Parliament, parliament
efirs: fires, fries
efirr: frier, rifer
adeiirs: dairies, diaries
lnoos: Olson, Solon, loons
'aeglmns: legman's, mangle's
ceoprstt: Prescott, protects
deerssst: desserts, stressed
abegmnoy: bogeyman, moneybag
deoprt: deport, ported
ceeorrsu: recourse, resource
cejnosu: jounces, juncoes
'acders: cadre's, cedar's
adeilns: Daniels, denials, snailed
adeilms: misdeal, mislead
ginostu: ousting, outings
adeills: dallies, sallied
'eenrsst: Ernest's, Sterne's
'clnoos: Colon's, colon's
eloss: loses, sloes, soles
elosv: loves, solve, voles
elosu: Seoul, louse
ademosw: Meadows, meadows
ademosy: Samoyed, someday
elotw: owlet, towel
'eenrstu: neuter's, tenure's, tureen's
aijnn: Jinan, ninja
agilnrstt: rattlings, startling
'abstu: Batu's, tabu's, tuba's
'aloprst: patrol's, portal's
'absst: bast's, stab's
'absss: Bass's, bass's
elorw: lower, rowel
elory: Elroy, Leroy
elorr: Errol, Lorre
elors: loser, roles
'aeimnrssu: Sumerian's, Suriname's, aneurism's
cenorst: Costner, cornets
bgilnott: blotting, bottling
aeprrs: parser, sparer
elops: Poles, lopes, poles, slope
cenortu: counter, recount, trounce
'aprsw: warp's, wrap's
aimost: Maoist, Taoism
accirt: Arctic, arctic
'aceilrst: article's, recital's
'apsst: past's, spat's
'ciopst: optic's, topic's
aekmrrs: markers, remarks
'apssw: WASP's, swap's, wasp's
'mnors: morn's, norm's
eilotv: Violet, violet
eilott: Lottie, toilet
aeprsy: payers, repays
aeprst: prates, repast, tapers
aeprss: Spears, parses, passer, spares, sparse, spears
lmpu: lump, plum
eilort: loiter, toiler
'aaclrsvy: Calvary's, cavalry's
'mnoos: Moon's, mono's, moon's
eenprss: Serpens, Spenser
eenprst: present, repents, serpent
'arssty: satyr's, stray's
adeilrt: trailed, trialed
'eeinrstty: entirety's, eternity's
cchhru: Church, church
dlors: Lords, lords
adeilst: details, dilates
eiprsst: persist, priests, spriest, sprites, stripes
cdeeirstt: directest, trisected
'cehpssy: Psyche's, psyche's
abhors: Hasbro, abhors
'acmrsy: Camry's, Marcy's
hrsttu: thrust, truths
ginorsu: rousing, souring
ginorst: sorting, storing
ehlos: Sheol, holes
ehlot: helot, hotel
'aglos: Olga's, goal's
ginortu: routing, touring
ehlps: helps, shlep
bcklnosu: sunblock, unblocks
'aglls: Gall's, gall's
ehlls: Hells, Shell, shell
elnny: Lenny, Lynne
aimprt: armpit, impart
elnor: Loren, enrol, loner
elnos: Noels, Olsen, noels
adempst: dampest, stamped
'adegrrs: Gerard's, grader's, regard's
'gpssyy: Gypsy's, gypsy's
aeijmns: Jasmine, jasmine
elssty: slyest, styles
'aprst: part's, tarp's, trap's
'aprss: rasp's, spar's
dehors: Rhodes, hordes, horsed, shored
eilprs: perils, pliers
eilpry: Ripley, ripely
'eeilmnosst: limestone's, milestone's
dehoop: hooped, poohed
aeehilrstt: earthliest, stealthier
acdemorst: Democrats, democrats
celorv: Velcro, clover
aacdinnor: Draconian, draconian
llmo: Moll, moll
eforsst: forests, fosters
beefginrrsttu: Butterfingers, butterfingers
amnos: Mason, Osman, mason, moans
amnor: Moran, Norma, Ramon, Roman, manor, roman
abdeert: berated, debater, rebated
abdeess: debases, seabeds
efillrs: fillers, refills
deopsu: pseudo, souped
abdeelt: belated, bleated
deopst: depots, despot, posted
cdeeirttu: certitude, rectitude
egiorst: goiters, goitres, goriest
aehilnqru: Harlequin, harlequin
aimosst: Maoists, Taoisms
'gnsu: gnu's, gun's
'koosty: Kyoto's, Tokyo's
aestttu: statute, tautest
acdeiimnot: decimation, medication
adeinst: detains, instead, stained
'ceirs: Eric's, rice's
adeinrs: sandier, sardine
adeinrr: drainer, randier
'cnosstu: Tucson's, Tuscon's
elmst: melts, smelt
'aknors: Akron's, Koran's
ceeiorst: coteries, esoteric
ginprsuu: pursuing, usurping
eiinnstt: Tientsin, tinniest
elmno: lemon, melon
ceinnnot: Innocent, innocent
ainrstt: Tristan, transit
aeppry: papery, prepay
aceprst: carpets, spectra
aceprss: parsecs, scrapes
erssstu: russets, trusses
arsst: stars, tsars
aainprsst: aspirants, partisans
arstt: start, tarts
arstw: straw, warts
arsty: artsy, satyr, stray, trays
ceilssu: Celsius, sluices
bcrsu: curbs, scrub
eeiinoprstt: petitioners, repetitions
aceilnosst: coastlines, sectionals
'aeilmss: Ismael's, Melisa's
'agils: Gail's, Gila's
'aeirss: Aries's, raise's
bbinors: Robbins, ribbons
'agins: Agni's, Gina's, gain's
cdnoor: condor, cordon
gstu: gust, guts, tugs
acehlmmnootw: Commonwealth, commonwealth
first: first, rifts
aeehrstw: weathers, wreathes
aeehrstt: theaters, theatres
adeimns: maidens, medians
ellsw: Wells, swell, wells
'aegllrsy: allergy's, gallery's
'ainoorst: Ontario's, oration's
effis: fiefs, fifes
eehinrt: neither, therein
ehitw: White, white
eemort: meteor, remote
abdegir: abridge, brigade
ahllosw: hallows, shallow
deilmnss: mildness, mindless
'hinpssx: Sphinx's, sphinx's
cchiks: Schick, chicks
eilrsv: livers, silver, sliver
eilrst: Lister, liters
eilrvy: livery, verily
'dgoos: Good's, good's
acdeilnoosst: consolidates, disconsolate
adeimrr: admirer, married
adeimrs: admires, misread, sidearm
'cgiinnoost: cognition's, incognito's
'aeilrrst: retrial's, trailer's
ehikt: Keith, Kieth
ehiks: hikes, sheik
ehins: Hines, shine
ehinr: Henri, Rhine
'adeeisss: disease's, seaside's
cimnors: crimson, microns
aceeiipprstt: peripatetics, precipitates
fisst: fists, sifts
'alnosst: Alston's, Salton's
fistw: Swift, swift
ehirs: Sheri, heirs, hires, shire
aiimnprstu: Puritanism, puritanism
'aglsss: Glass's, glass's
